Id,Price,Bedroom_Count,Bathroom_Count,Sqft_Living,Sqft_Plot,Floor_Count,Waterfront,View,Condition,Grade,Sqft_Above,Sqft_Basement,Zipcode,Latitude,Longitude,Sqft_Living_2015,Sqft_Plot_2015,Plot_Living,Plot-Living_2015,Age,Change_In_Sqft_Living,Change_In_Sqft_Plot,Listing_per_Zip_Code,Zipcode_Median_housePrice,sqft_living_zipcode_ratio,sqft_lot_zipcode_ratio,sqft_above_zipcode_ratio,sqft_basement_zipcode_ratio,sqft_living15_zipcode_ratio,sqft_lot15_zipcode_ratio,sqft_median_price_zipcode_ratio
3862710030,450000.0,3,2.5,1800,4357,2.0,0,0,3,8,1800,0,98065,47.5337,-121.841,1800,3663,2557,1863,7,0,-694,305,500000.0,0.0022855691702114,0.0008286363957949,0.0023946360153256,0.0,0.0023344638190531,0.0010608759771397,0.9
6647400250,439950.0,3,2.5,1540,7773,2.0,0,0,4,8,1540,0,98034,47.722,-122.194,1630,7340,6233,5710,38,90,-433,543,446000.0,0.0014340682467491,0.0014651234460276,0.0017064090062937,0.0,0.001569050243299,0.0015919643538793,0.9864349775784752
2800031,235000.0,3,1.0,1430,7599,1.5,0,0,4,6,1010,420,98168,47.4783,-122.265,1290,10320,6169,9030,90,-140,2721,264,237000.0,0.0036707138640039,0.0025357986764726,0.0030855711361622,0.0067480719794344,0.0033091177738102,0.0040005411584745,0.9915611814345991
251200240,491500.0,4,2.75,2100,7236,1.0,0,0,3,8,1400,700,98034,47.7267,-122.232,1900,7519,5136,5619,41,-200,283,543,446000.0,0.0019555476092033,0.001363904960177,0.0015512809148125,0.0040842999509884,0.0018289542713301,0.0016307874627818,1.102017937219731
1025039086,1875000.0,3,2.5,3280,29111,2.0,1,3,3,11,3280,0,98199,47.6699,-122.416,3530,21074,25831,17544,95,250,-8037,316,689900.0,0.0048004449192852,0.016935318729086,0.0065220417172058,0.0,0.0056069125448711,0.0126256332587242,2.717785186258878
8899000310,288000.0,3,1.5,1300,7313,1.0,0,0,4,7,1300,0,98055,47.4568,-122.21,1770,8075,6013,6305,52,470,762,260,297225.0,0.002795807149524,0.002788737056378,0.0031505222596515,0.0,0.003810261874778,0.0040873182788416,0.9689629068887208
395300650,326250.0,3,1.0,1060,9663,1.0,0,0,3,7,1060,0,98034,47.7244,-122.226,1320,10162,8603,8842,53,260,499,543,446000.0,0.000987085936074,0.0018213672789097,0.0011745412640723,0.0,0.0012706419148188,0.0022040247635043,0.7315022421524664
7379700051,375000.0,3,1.75,1590,14766,1.0,0,0,3,8,1590,0,98007,47.5902,-122.147,2040,10190,13176,8150,57,450,-4576,139,560000.0,0.0052215033989031,0.00992865168426,0.0060520706455542,0.0,0.0068849139385757,0.0076405020087247,0.6696428571428571
3304040130,375900.0,3,2.0,1824,7120,1.0,0,0,3,9,1824,0,98001,47.3457,-122.27,2409,6264,5296,3855,10,585,-856,358,260000.0,0.0026699611801696,0.0013288617384684,0.0029506637375721,0.0,0.003672502423943,0.0015622034550533,1.4457692307692307
8651200040,950000.0,4,2.5,2790,15653,2.0,0,0,4,10,2790,0,98040,47.5477,-122.215,3520,15653,12863,12133,56,730,0,282,993750.0,0.0031844698314285,0.0040502926648897,0.0039985037856801,0.0,0.0043060948368454,0.0043360567230347,0.9559748427672956
1523049188,84000.0,2,1.0,700,20130,1.0,0,0,3,6,700,0,98168,47.4752,-122.271,1490,18630,19430,17140,71,790,-1500,264,237000.0,0.0017968529404214,0.0067174137856814,0.0021385146488253,0.0,0.0038221592891296,0.0072219071494554,0.3544303797468354
1972201773,670000.0,2,2.0,1500,761,3.0,0,3,3,8,1500,0,98103,47.6522,-122.346,1360,1527,-739,167,12,-140,766,599,550000.0,0.0015166681833348,0.0003651335376353,0.0017822622135459,0.0,0.0014900190634791,0.0007343549218611,1.2181818181818185
8929000280,386591.0,3,2.5,1690,1613,2.0,0,0,3,8,1150,540,98029,47.5518,-121.998,1690,1662,-77,-28,6,0,49,320,574500.0,0.002314941647033,0.0005800292999301,0.0016565831172572,0.0150669642857142,0.0023875789384456,0.0007365806702086,0.672917319408181
7454001405,387500.0,4,1.0,1370,7140,2.0,0,0,3,6,1370,0,98146,47.512,-122.376,1090,6300,5770,5210,78,-280,-840,281,312000.0,0.0029969068421351,0.0028198929625503,0.0035373278457415,0.0,0.0025211755617132,0.0027124096616893,1.2419871794871795
6817800330,405000.0,2,1.0,1090,10481,1.0,0,0,2,7,780,310,98074,47.632,-122.03,1160,10533,9391,9373,39,70,52,435,645000.0,0.0009449263954352,0.0016514793905424,0.0007330213920076,0.0034660107334525,0.0010296458107173,0.0018324768552588,0.627906976744186
1093000090,776000.0,2,2.0,1990,6180,1.0,0,0,4,7,1010,980,98115,47.6792,-122.303,1470,5150,4190,3680,79,-520,-1030,576,570000.0,0.0018842787709957,0.0019684381016994,0.0012450920566825,0.0040012738749479,0.0015086655904167,0.0016916077532788,1.3614035087719298
7787920160,472000.0,5,2.5,2570,7412,2.0,0,0,3,8,2570,0,98019,47.7265,-121.957,2890,8056,4842,5166,14,320,644,190,401250.0,0.0062288534062375,0.0009792195915787,0.0066427836623708,0.0,0.0072302961919606,0.0011454348180619,1.1763239875389409
2944500470,257000.0,4,2.75,2330,7642,1.0,0,0,3,8,1800,530,98023,47.2946,-122.37,2320,7933,5312,5613,30,-10,291,492,269000.0,0.0023695116060305,0.0014796642970481,0.0021355327739028,0.0037737461194497,0.0023922655579753,0.0016536061036471,0.9553903345724908
6600060150,392000.0,4,2.5,2130,4028,2.0,0,0,3,8,2130,0,98146,47.5108,-122.363,1830,7817,1898,5987,6,-300,3789,281,312000.0,0.0046594245063853,0.00159083037159,0.0054996411032331,0.0,0.0042327993375553,0.0033655406865754,1.2564102564102564
6672700120,459000.0,4,1.75,2260,9703,1.0,0,0,2,8,1660,600,98052,47.6622,-122.145,2390,8455,7443,6065,42,130,-1248,571,615000.0,0.0016720700671343,0.0015285249568758,0.001381482147256,0.0039997333511099,0.0017924251662493,0.0014733923294376,0.7463414634146341
2608300035,329000.0,3,1.0,1600,5952,1.0,0,0,4,7,1150,450,98106,47.5292,-122.362,1460,6200,4352,4740,56,-140,248,330,315000.0,0.0032512989955518,0.0032588823982571,0.0029245640492242,0.0045505106684194,0.0032454397126229,0.0036849356265519,1.0444444444444445
6072760360,665000.0,4,2.25,2650,8149,1.0,0,0,4,8,1610,1040,98006,47.5624,-122.176,2290,8019,5499,5729,45,-360,-130,490,760184.5,0.0018746847523046,0.0012383405051924,0.0014284180669156,0.0036306510734857,0.0016790271907088,0.0013422666010291,0.8747876337915335
9275700005,1052000.0,3,2.25,2880,6092,2.0,0,4,4,8,1920,960,98116,47.5878,-122.381,2880,5308,3212,2428,37,0,-784,329,565500.0,0.0047190525191219,0.0037186952336362,0.0041099233242429,0.0067071892684971,0.0051656505760238,0.0032745158398843,1.8603006189213085
3232200095,615000.0,4,1.0,1340,2006,1.5,0,0,3,7,1340,0,98119,47.6357,-122.373,2040,3625,666,1585,89,700,1619,184,744975.0,0.0036311115808071,0.0030156343956704,0.0045803666344217,0.0,0.0059433632443771,0.0052853429057575,0.8255310580891976
1862400226,505000.0,2,1.0,1070,8130,1.0,0,0,3,7,1070,0,98117,47.697,-122.37,1360,7653,7060,6293,78,290,-477,548,545000.0,0.001153143987809,0.0032001032850063,0.0014628517679999,0.0,0.0016114125927154,0.0030085326278174,0.926605504587156
7885100005,299000.0,4,2.0,2320,12000,1.0,0,0,3,7,1720,600,98108,47.5246,-122.325,1390,6000,9680,4610,77,-930,-6000,185,345000.0,0.0073527081418565,0.0124325147558409,0.0071571238348868,0.0079776625448743,0.0047817262375726,0.0064125652077724,0.8666666666666667
3192000085,180000.0,3,1.0,1010,10215,1.0,0,0,3,6,1010,0,98146,47.4872,-122.345,1320,10245,9205,8925,65,310,30,281,312000.0,0.0022093984748587,0.0040343426628083,0.0026078110395612,0.0,0.0030531667352858,0.0044108947593662,0.5769230769230769
1025049114,625504.0,3,2.25,1270,1566,2.0,0,0,3,8,1060,210,98105,47.6647,-122.284,1160,1327,296,167,6,-110,-239,229,675000.0,0.0025787744526703,0.0013353263747423,0.0027333536185991,0.0020061138708444,0.0024970132707644,0.0011732616585693,0.9266725925925926
686400670,678000.0,3,1.75,1670,7210,1.0,0,0,5,8,1670,0,98008,47.6344,-122.116,2200,7210,5540,5010,53,530,0,283,545000.0,0.002765976828733,0.0025005800582728,0.0034446910504038,0.0,0.0038462883317598,0.0026832060330082,1.2440366972477064
2517010230,286000.0,3,2.5,1800,3980,2.0,0,0,3,7,1800,0,98042,47.4006,-122.162,2580,4307,2180,1727,14,780,327,546,292000.0,0.0016623906285498,0.0003836626791454,0.0017844609143577,0.0,0.0024144033195238,0.0005355060264632,0.9794520547945206
6117502220,1575000.0,3,3.0,2610,22672,1.5,1,4,4,8,2610,0,98166,47.4414,-122.354,2810,22672,20062,19862,68,200,0,250,392500.0,0.0050278554751612,0.0066380341909119,0.006091583811791,0.0,0.00594671237805,0.0071260706628861,4.012738853503185
2473000410,479950.0,4,2.25,2570,11070,2.0,0,0,4,8,2570,0,98058,47.4507,-122.152,2210,9600,8500,7390,54,-360,-1470,451,335000.0,0.0027731857753913,0.0012539971868323,0.0031499653136115,0.0,0.002475416648465,0.0015428837300499,1.432686567164179
1622049154,289900.0,3,1.75,1899,11325,2.0,0,0,3,7,1899,0,98198,47.3987,-122.3,2000,10454,9426,8454,77,101,-871,275,266750.0,0.0039470320356001,0.0039022228715398,0.0046728397036351,0.0,0.0042383656861914,0.0040006337334477,1.0867853795688849
312000295,400000.0,2,1.0,920,5120,1.0,0,0,5,7,920,0,98136,47.5569,-122.394,1190,5120,4200,3930,68,270,0,263,489950.0,0.0020257356503051,0.0032542028156481,0.002587103849723,0.0,0.0027058984037473,0.0033836944259582,0.8164098377385447
1529200340,496500.0,3,2.5,2260,3640,2.0,0,0,3,8,2260,0,98072,47.7356,-122.157,2350,3710,1380,1360,26,90,70,272,517500.0,0.0035066105815853,0.0004345492953795,0.0039897537474556,0.0,0.0036666042563814,0.0005685917866533,0.9594202898550724
1133000235,450000.0,6,2.25,3550,11780,1.0,0,0,4,8,2960,590,98125,47.7218,-122.312,2360,8850,8230,6490,72,-1190,-2930,402,425000.0,0.0050408378866535,0.0038089658140468,0.0051719950446696,0.0044718990411945,0.0035373929414021,0.0030066983123079,1.0588235294117647
616000160,381000.0,3,2.0,1770,14400,1.0,0,0,4,8,1770,0,98166,47.415,-122.337,1900,14400,12630,12500,61,130,0,250,392500.0,0.0034096950923507,0.0042161120478622,0.0041310740792606,0.0,0.0040209087253719,0.0045260858127011,0.9707006369426752
1822059073,300000.0,3,1.0,1380,12000,1.0,0,0,3,7,1380,0,98031,47.3997,-122.215,1890,22001,10620,20111,57,510,10001,271,288400.0,0.0026353681685718,0.0036478787736925,0.0029800080330651,0.0,0.0036488811063253,0.0095640138167635,1.0402219140083218
7387500335,280000.0,3,1.0,980,7480,1.0,0,0,3,6,830,150,98106,47.5206,-122.363,1140,7480,6500,6340,72,160,0,330,315000.0,0.0019914206347754,0.0040955040892075,0.0021107723137879,0.0015168368894731,0.0025341104605412,0.0044456965300981,0.8888888888888888
8902500118,326000.0,3,2.5,1782,1577,3.0,0,0,3,7,1782,0,98125,47.7114,-122.301,1550,1744,-205,194,20,-232,167,402,425000.0,0.0025303586236666,0.0005099099396223,0.0031136808005409,0.0,0.0023232877369378,0.0005925064244819,0.7670588235294118
1036450170,660000.0,3,3.5,2740,3785,2.0,0,0,3,9,2190,550,98034,47.7195,-122.182,2060,3457,1045,1397,19,-680,-328,543,446000.0,0.0025515240234367,0.0007134301097664,0.0024266465738852,0.0032090928186337,0.0019829714731264,0.0007497848462344,1.4798206278026906
291310150,391000.0,3,2.25,1410,1290,2.0,0,0,3,7,1290,120,98027,47.5345,-122.069,1490,1380,-120,-110,16,80,90,411,571000.0,0.0013635321866124,9.531642429818112e-05,0.0014843470426398,0.0007272286528089,0.0015252344408173,0.0001178241164279,0.6847635726795096
2838000130,722000.0,3,2.5,2230,4850,2.0,0,0,3,8,2230,0,98133,47.7295,-122.334,2230,4513,2620,2283,6,0,-337,484,375000.0,0.0028560523976751,0.0014120411885136,0.0033739110437337,0.0,0.0029718236469206,0.0013868304271763,1.9253333333333331
182000350,287500.0,5,2.0,2020,67953,1.5,0,0,4,7,1620,400,98178,47.4891,-122.263,1270,13198,65933,11928,84,-750,-54755,258,279500.0,0.0045081235493661,0.0317006767177556,0.0047220683825458,0.0038091610322826,0.0029824108212197,0.00629031835264,1.0286225402504472
4322300140,265000.0,3,2.25,1450,13439,1.0,0,0,4,7,1180,270,98003,47.2811,-122.299,1520,12348,11989,10828,57,70,-1091,276,269500.0,0.002720057327553,0.0045827198147133,0.0025702797248493,0.0036494870443209,0.0029287372710719,0.0045784985580028,0.9833024118738404
7242800040,519990.0,4,3.25,1690,1321,2.0,0,0,3,8,1320,370,98052,47.678,-122.117,3080,4558,-369,1478,6,1390,3237,571,615000.0,0.0012503532802907,0.0002080986775258,0.0010985279725168,0.0024665022331844,0.0023099035615263,0.0007942900340126,0.8455121951219512
7686204750,205000.0,4,1.5,1420,8063,1.0,0,0,3,7,940,480,98198,47.4174,-122.316,1330,7515,6643,6185,58,-90,-548,275,266750.0,0.0029514404900222,0.0027782448576799,0.0023130433498773,0.0064231232436772,0.0028185131813172,0.0028759099394355,0.7685098406747891
2126049277,500000.0,3,1.75,1800,7199,1.0,0,0,3,7,1300,500,98125,47.7264,-122.307,1800,8100,5399,6300,48,0,901,402,425000.0,0.0025559178016834,0.0023277372576674,0.0022714843101589,0.0037897449501648,0.0026980115654762,0.0027518933705869,1.1764705882352942
3023039066,329500.0,3,1.0,1810,13068,1.0,0,0,4,7,1360,450,98070,47.4482,-122.462,1400,13068,11258,11668,79,-410,0,116,466250.0,0.0082086912352946,0.0011661520355992,0.0069274300762526,0.0186127311080779,0.0068070209559002,0.0013990627307481,0.7067024128686327
9323600380,817000.0,4,2.25,2600,10660,2.0,0,0,4,8,2600,0,98006,47.5533,-122.156,3150,10660,8060,7510,41,550,0,490,760184.5,0.0018393133418837,0.0016199177549824,0.0023067620956401,0.0,0.0023095788867829,0.0017843324562876,1.074739092943884
3810000465,243000.0,2,1.0,1770,5522,1.5,0,0,4,7,960,810,98178,47.4974,-122.231,1830,7378,3752,5548,77,60,1856,258,279500.0,0.0039501874665238,0.0025760619374486,0.0027982627452123,0.0077135510903723,0.0042974896085292,0.0035164395215773,0.8694096601073346
5566100060,490000.0,3,1.75,1720,12540,1.0,0,0,4,7,1720,0,98006,47.5699,-122.177,1440,11850,10820,10410,64,-280,-690,490,760184.5,0.0012167765184769,0.0019056068149605,0.001526011847885,0.0,0.0010558074911007,0.0019835215391189,0.64458036174113
6332000050,464000.0,3,2.0,1630,6550,1.0,0,0,5,7,850,780,98126,47.5452,-122.379,1440,6550,4920,5110,108,-190,0,352,396587.5,0.0029971885268358,0.0036483990490768,0.0019337387359718,0.0074798619102416,0.0028967198670727,0.003709083290155,1.169981403851609
1005000250,350000.0,2,1.0,840,5551,1.0,0,0,3,6,840,0,98118,47.5354,-122.28,1270,4652,4711,3382,68,430,-899,498,370000.0,0.000994309942981,0.001926064922024,0.0012645555614099,0.0,0.0015812796412113,0.0016806164090588,0.945945945945946
2641800060,239000.0,3,1.0,940,8571,1.0,0,0,3,6,940,0,98146,47.5006,-122.336,1100,8573,7631,7473,70,160,2,281,312000.0,0.0020562718478883,0.0033850563840362,0.0024270716605817,0.0,0.0025443056127381,0.0036910298459781,0.7660256410256411
1442300005,435000.0,3,2.0,2040,6880,2.0,0,0,4,7,2040,0,98133,47.7601,-122.351,1710,7597,4840,5887,66,-330,717,484,375000.0,0.0026127116104293,0.0020030604900976,0.0030864477709492,0.0,0.0022788423480871,0.0023345337370393,1.16
6844702290,400000.0,2,1.0,1470,6120,1.0,0,0,2,7,1470,0,98115,47.6914,-122.287,1840,6120,4650,4280,80,370,0,576,570000.0,0.0013919044187757,0.0019493270521683,0.0018121636864586,0.0,0.0018883977458278,0.0020102212524401,0.7017543859649122
9542000075,700000.0,3,1.75,2000,14733,1.0,0,0,4,8,2000,0,98005,47.6001,-122.178,2620,14733,12733,12113,62,620,0,168,765475.0,0.0044808588910322,0.0044004903173084,0.0055109626825161,0.0,0.0060732358061293,0.0047744723710587,0.9144648747509716
9218400050,475000.0,4,3.0,2400,5400,2.0,0,2,4,7,1600,800,98178,47.5099,-122.26,2400,5400,3000,3000,55,0,0,258,279500.0,0.0053561863952865,0.0025191478562518,0.0046637712420205,0.0076183220645652,0.005636051945612,0.0025737020082024,1.699463327370304
179001455,445000.0,4,3.25,3450,5000,2.0,0,0,3,8,3450,0,98178,47.4925,-122.273,1420,5000,1550,3580,12,-2030,0,258,279500.0,0.0076995179432244,0.0023325443113442,0.0100562567406068,0.0,0.0033346640678204,0.0023830574150022,1.592128801431127
6169900545,1330000.0,3,1.5,1940,2885,1.5,0,2,3,8,1940,0,98119,47.6308,-122.369,2550,3600,945,1050,120,610,715,184,744975.0,0.0052569824378849,0.0043370414912808,0.0066312770677449,0.0,0.0074292040554713,0.0052488922650282,1.7852948085506226
7334602070,290000.0,3,1.75,1710,10950,1.0,0,0,3,7,1060,650,98045,47.4678,-121.745,1180,10950,9240,9770,53,-530,0,218,404750.0,0.003788927910661,0.0009928541701235,0.002500206384961,0.0237659963436928,0.0028244868649392,0.0015479550100659,0.7164916615194564
6431000748,331000.0,3,3.25,1290,1153,3.0,0,0,3,7,1290,0,98103,47.6904,-122.346,1290,1200,-137,-90,12,0,47,599,550000.0,0.0013043346376679,0.0005532180931584,0.0015327455036494,0.0,0.0014133269058001,0.0005770962057848,0.6018181818181818
7942600006,345000.0,3,1.0,1390,2640,1.5,0,0,3,7,1230,160,98122,47.6078,-122.307,1780,3920,1250,2140,117,390,1280,289,574000.0,0.0026887752338654,0.0026068898914882,0.0028460758861014,0.0018870149781813,0.0035981548338582,0.0038125805431954,0.6010452961672473
7207900030,400000.0,4,3.5,2370,3692,2.5,0,0,3,8,2370,0,98056,47.5044,-122.17,2520,5425,1322,2905,7,150,1733,404,380000.0,0.0029092569610417,0.0009541087146408,0.0032814758610758,0.0,0.003267147663406,0.0017144549250048,1.0526315789473684
1250204835,1240000.0,4,3.0,3330,6990,1.5,0,3,5,9,2330,1000,98144,47.5886,-122.287,2620,5310,3660,2690,92,-710,-1680,340,452500.0,0.00512320303269,0.0050195431856649,0.0046303564579561,0.006812778046504,0.0043755124944262,0.0039800085146698,2.7403314917127077
8081020380,1200000.0,4,2.5,3350,11688,1.0,0,2,3,10,1760,1590,98006,47.5507,-122.133,4240,10804,8338,6564,25,890,-884,490,760184.5,0.0023698844981964,0.0017761349643747,0.0015615004955102,0.0055507069296561,0.0031087665015745,0.001808436009168,1.5785641512027673
7645900235,880000.0,6,2.5,2640,3680,2.0,0,0,5,8,1760,880,98126,47.5771,-122.38,1960,3680,1040,1720,98,-680,0,352,396587.5,0.0048543421538936,0.0020497875573439,0.0040039766768358,0.0084388185654008,0.003942757596849,0.0020838819095833,2.218930248684086
8151600941,340000.0,3,1.75,1720,10710,1.0,0,0,3,7,860,860,98146,47.5092,-122.362,1480,10359,8990,8879,63,-240,-351,281,312000.0,0.0037625399769872,0.0042298394438254,0.0022205123703194,0.0123138602520045,0.003423247551684,0.0044599764580063,1.0897435897435896
200800200,595000.0,4,2.25,2050,8372,2.0,0,0,4,8,2050,0,98052,47.7234,-122.107,2010,8037,6322,6027,36,-40,-335,571,615000.0,0.001516700724613,0.0013188509676352,0.001706047230045,0.0,0.0015074370645025,0.0014005504614654,0.967479674796748
869700140,292000.0,3,2.5,1560,2740,2.0,0,0,3,8,1560,0,98059,47.4909,-122.154,1310,2698,1180,1388,21,-250,-42,465,435000.0,0.0013918505366654,0.0004087109123576,0.0014742850662483,0.0,0.0011974591926931,0.000460634606976,0.671264367816092
2122039137,462500.0,3,2.5,1656,108900,1.0,0,0,4,7,1656,0,98070,47.3758,-122.425,2030,29859,107244,27829,35,374,-79041,116,466250.0,0.0075102722020154,0.0097179336299935,0.0084351648575547,0.0,0.0098701803860553,0.0031967105966796,0.9919571045576407
5160700035,431000.0,2,1.5,1300,4000,1.5,0,0,4,6,1300,0,98144,47.5937,-122.301,1480,4000,2700,2520,120,180,0,340,452500.0,0.002000049231981,0.0028724138401516,0.0025834606846965,0.0,0.0024716635464697,0.0029981231748925,0.952486187845304
9558000100,405000.0,5,2.5,2430,4781,2.0,0,0,3,9,2430,0,98058,47.4487,-122.117,2420,4770,2351,2350,19,-10,-11,451,335000.0,0.0026221172895723,0.000541586318902,0.0029783718724031,0.0,0.0027106372349708,0.0007666203533685,1.208955223880597
3295730050,569000.0,3,2.5,2150,8060,2.0,0,0,3,8,2150,0,98033,47.6952,-122.188,2150,7172,5910,5022,25,0,-888,431,678000.0,0.0020965198745208,0.0017796277663441,0.0024237286415959,0.0,0.0022600129083527,0.0016758508997417,0.8392330383480826
2077700042,530000.0,3,2.0,2330,26571,2.5,0,0,3,8,2330,0,98005,47.6009,-122.158,2030,20037,24241,18007,33,-300,-6534,168,765475.0,0.0052202006080525,0.0079362945918144,0.0064202715251313,0.0,0.0047055987352834,0.006493321312625,0.6923805480257357
1222069129,1125000.0,4,3.25,3890,422096,1.5,0,0,3,9,3150,740,98038,47.4125,-121.982,2180,229996,418206,227816,19,-1710,-192100,586,342750.0,0.0030859251667113,0.0283355737064865,0.002612347530129,0.0135159817351598,0.0017547262908708,0.0196125716382955,3.2822757111597376
686200740,500000.0,4,2.25,2080,8000,1.0,0,0,3,8,1390,690,98008,47.6264,-122.113,1800,7700,5920,5900,56,-280,-300,283,545000.0,0.0034450489842902,0.0027745687193041,0.0028671380599169,0.0058002202402468,0.0031469631805307,0.0028655598410767,0.9174311926605504
3524039228,394000.0,3,2.0,1160,3441,1.0,0,0,4,6,580,580,98136,47.5314,-122.392,1160,4000,2281,2840,90,0,559,263,489950.0,0.0025541884286456,0.002187053103251,0.0016310002530862,0.005885576279098,0.0026376824776024,0.0026435112702798,0.8041636901724666
8945000260,209950.0,4,1.0,1630,8400,1.0,0,0,3,6,1630,0,98023,47.3052,-122.362,1190,8989,6770,7799,58,-440,589,492,269000.0,0.0016576411664505,0.0016264302663182,0.0019338435674786,0.0,0.0012270672474097,0.0018737256101958,0.7804832713754647
3935900350,490000.0,4,2.0,1650,6480,2.0,0,0,5,7,1650,0,98125,47.7117,-122.286,1650,6350,4830,4700,73,0,-130,402,425000.0,0.0023429246515432,0.0020952545394756,0.0028830377782786,0.0,0.0024731772683532,0.0021573485065712,1.152941176470588
11900140,254000.0,3,2.5,1850,4597,2.0,0,0,3,8,1850,0,98042,47.3755,-122.136,2210,5000,2747,2790,17,360,403,546,292000.0,0.0017085681460096,0.0004431400341787,0.0018340292730899,0.0,0.0020681516806773,0.0006216694061565,0.8698630136986302
705700640,353000.0,3,2.75,2170,8396,2.0,0,0,3,7,2170,0,98038,47.3812,-122.023,2170,8378,6226,6208,25,0,-18,586,342750.0,0.0017214543989109,0.0005636288352404,0.0017996171874222,0.0,0.0017466770877017,0.0007144216646621,1.0299051787016775
7852060370,355000.0,3,2.5,1590,4242,2.0,0,0,3,7,1590,0,98065,47.5309,-121.876,1590,3702,2652,2112,20,0,-540,305,500000.0,0.0020189194336867,0.0008067651115359,0.0021152618135376,0.0,0.0020621097068302,0.0010721711349635,0.71
3754500566,749950.0,4,2.5,2370,2971,2.0,0,2,3,9,2080,290,98034,47.7064,-122.224,2970,7500,601,4530,12,600,4529,543,446000.0,0.002206975158958,0.0005600002261865,0.0023047602162928,0.0016920671225523,0.0028589443083424,0.0016266665741274,1.6815022421524664
6385900090,277500.0,4,2.25,1660,7184,1.0,0,0,3,7,1110,550,98188,47.4678,-122.294,1640,7200,5524,5560,57,-20,16,135,265000.0,0.0068081057471075,0.0052497466105738,0.0055064167117266,0.0130196004166272,0.007412965457389,0.0054641449637658,1.0471698113207548
4046600320,420000.0,3,2.25,2020,21010,2.0,0,0,3,7,2020,0,98014,47.6988,-121.915,1850,18151,18990,16301,25,-170,-2859,123,415000.0,0.0077517000015349,0.0017516837758064,0.0082814716421092,0.0,0.0078128959237799,0.0018813826146191,1.0120481927710845
9544700730,914500.0,4,2.5,3950,10856,3.0,0,0,3,10,3950,0,98075,47.5818,-121.996,3200,10856,6906,7656,7,-750,0,358,739999.5,0.0036538313890941,0.0015944875615723,0.0038909470959251,0.0,0.0029967681728236,0.0020140792600299,1.2358116458186796
6154500030,1080000.0,4,3.5,3990,5267,2.0,0,0,3,10,3990,0,98006,47.5641,-122.124,3230,6481,1277,3251,12,-760,1214,490,760184.5,0.0028226385515831,0.0008003852547366,0.0035399926006169,0.0,0.0023682348585107,0.0010848272654033,1.4207077360824905
3241600015,250000.0,3,1.0,1130,7800,1.0,0,0,3,7,1130,0,98118,47.5239,-122.288,1170,7800,6670,6630,68,40,0,498,370000.0,0.0013375836137721,0.0027064144103382,0.0017011283147539,0.0,0.0014567694332419,0.0028178864984219,0.6756756756756757
2781250610,250000.0,3,2.0,1470,2781,2.0,0,0,3,6,1470,0,98038,47.349,-122.024,1360,3008,1311,1648,17,-110,227,586,342750.0,0.0011661465282945,0.0001866903038117,0.0012190955140602,0.0,0.0010946916310019,0.0002565027891267,0.7293946024799417
9406540190,315000.0,4,2.5,1780,6000,2.0,0,0,3,9,1780,0,98038,47.3774,-122.027,2650,6000,4220,3350,20,870,0,586,342750.0,0.0014120685852818,0.0004027838269941,0.0014761836836919,0.0,0.00213303883982,0.0005116412017155,0.9190371991247264
5071400485,637000.0,3,2.0,1980,6000,1.0,0,0,4,7,1380,600,98115,47.6921,-122.283,1260,6000,4020,4740,62,-720,0,576,570000.0,0.001874810033453,0.0019111049531062,0.0017012148893285,0.0024497595152742,0.0012931419346429,0.001970805149451,1.1175438596491227
9378500050,295000.0,4,2.5,2350,8906,2.0,0,0,3,7,2350,0,98031,47.4205,-122.215,2000,8165,6556,6165,27,-350,-741,271,288400.0,0.0044877646348869,0.0027073340298755,0.0050746513606543,0.0,0.0038612498479632,0.0035493919737227,1.022884882108183
2621750110,334950.0,4,2.5,2190,7000,2.0,0,0,3,8,2190,0,98042,47.3718,-122.109,2040,7700,4810,5660,23,-150,700,546,292000.0,0.0020225752647357,0.0006747836065371,0.0021710941124686,0.0,0.001909063089856,0.000957370885481,1.1470890410958905
4038700220,610000.0,6,2.75,2040,8560,1.0,0,2,4,7,1100,940,98008,47.616,-122.115,2230,8560,6520,6330,59,190,0,283,545000.0,0.0033787980422846,0.0029687885296554,0.0022689581769127,0.0079017493127999,0.003898737718102,0.0031856093817684,1.1192660550458715
3353404265,460000.0,3,2.5,2720,40813,2.0,0,0,3,8,2720,0,98001,47.2619,-122.271,2250,40511,38093,38261,19,-470,-302,358,260000.0,0.0039815210581477,0.0076172519848472,0.0044001125911163,0.0,0.0034301081170078,0.0101031967062047,1.7692307692307692
7942601155,302282.0,2,1.0,1095,5120,1.5,0,0,3,7,1095,0,98122,47.6058,-122.313,1310,5120,4025,3810,119,215,0,289,574000.0,0.0021181358856709,0.0050557864562195,0.0025337017034805,0.0,0.0026480802428956,0.0049796970360104,0.526623693379791
7883603965,315000.0,4,2.0,1210,4250,1.0,0,0,4,7,1210,0,98108,47.5275,-122.321,1210,6000,3040,4790,79,0,1750,185,345000.0,0.0038348176084682,0.0044031823093603,0.0050349533954727,0.0,0.0041625098902611,0.0064125652077724,0.9130434782608696
2848700095,412000.0,4,1.5,1960,5000,1.0,0,0,3,7,980,980,98106,47.5688,-122.363,1300,5000,3040,3700,108,-660,0,330,315000.0,0.0039828412695509,0.002737636423267,0.0024922371897736,0.0099100010112245,0.0028897750865821,0.0029717222794774,1.307936507936508
3083000940,341000.0,2,1.0,1040,4000,1.0,0,0,3,6,1040,0,98144,47.5753,-122.303,1740,4000,2960,2260,106,700,0,340,452500.0,0.0016000393855848,0.0028724138401516,0.0020667685477572,0.0,0.0029058747100387,0.0029981231748925,0.7535911602209945
3586501085,630000.0,4,2.5,2290,26720,2.0,0,0,3,8,2290,0,98177,47.7502,-122.374,2290,26720,24430,24430,43,0,0,254,557000.0,0.0038768876549062,0.0088244347011647,0.0049026744196004,0.0,0.0041238969926166,0.0089878327886365,1.131059245960503
5100402644,525000.0,4,1.5,1430,6380,1.5,0,0,4,7,1130,300,98115,47.6942,-122.319,1570,6380,4950,4810,75,140,0,576,570000.0,0.0013540294686049,0.0020321416001363,0.0013930237861893,0.0012248797576371,0.00161129590269,0.0020956228089163,0.9210526315789472
8125200483,288350.0,3,1.5,1860,7963,1.0,0,0,3,7,1200,660,98188,47.4513,-122.268,1800,10400,6103,8600,57,-60,2437,135,265000.0,0.0076283594515783,0.0058190050473273,0.0059528829315964,0.0156235204999526,0.0081361815995733,0.0078926538365507,1.0881132075471698
4140090240,520000.0,3,2.25,2590,9263,1.0,0,0,5,8,1440,1150,98028,47.7691,-122.262,2580,9450,6673,6870,43,-10,187,282,442500.0,0.0043240824680994,0.0027600085693454,0.0028657229681725,0.0119195688225538,0.0043751950183826,0.0033143927769385,1.1751412429378532
7852180560,403000.0,3,2.5,1700,4125,2.0,0,0,3,7,1700,0,98065,47.5305,-121.854,1970,4105,2425,2135,16,270,-20,305,500000.0,0.0021585931051996,0.0007845134571159,0.0022616006811409,0.0,0.0025549409575192,0.001188887765809,0.806
7229900285,390000.0,3,2.0,1840,16815,1.0,0,0,5,7,960,880,98059,47.4837,-122.11,1810,16732,14975,14922,48,-30,-83,465,435000.0,0.0016416698637592,0.0025082021866033,0.0009072523484605,0.0140418062868996,0.0016545046860874,0.002856685783515,0.896551724137931
2329600280,225900.0,3,1.0,1510,8800,1.0,0,0,4,7,1010,500,98003,47.329,-122.33,1290,8470,7290,7180,57,-220,-330,276,269500.0,0.0028326114238655,0.0030008136296955,0.0021999851882185,0.0067583093413351,0.0024855730787387,0.0031405800766346,0.8382189239332096
325059286,819900.0,5,2.75,3150,7119,2.0,0,0,3,9,3150,0,98052,47.6759,-122.151,1560,8384,3969,6824,7,-1590,1265,571,615000.0,0.00233054013782,0.00112146440977,0.0026214872071424,0.0,0.0011699511545392,0.0014610196676528,1.3331707317073171
1180007005,265950.0,3,1.5,1150,8450,1.0,0,0,4,6,1150,0,98178,47.4927,-122.224,1160,6800,7300,5640,69,10,-1650,258,279500.0,0.0025665059810748,0.0039419998861718,0.0033520855802022,0.0,0.0027240917737125,0.0032409580844031,0.951520572450805
8819900055,503000.0,2,1.0,870,4280,1.0,0,2,4,6,870,0,98105,47.6697,-122.29,1750,4280,3410,2530,99,880,0,229,675000.0,0.0017665620266324,0.0036495510114287,0.0022434128756427,0.0,0.0037670458826188,0.0037841446109094,0.7451851851851852
7428000120,176000.0,3,2.25,1540,5449,1.0,0,0,2,7,1180,360,98023,47.29,-122.358,1460,6740,3909,5280,31,-80,1291,492,269000.0,0.0015661149670759,0.0010550498239486,0.0013999603740029,0.0025632992509469,0.0015054774632086,0.0014049294262676,0.654275092936803
2545900050,234950.0,3,1.0,1360,9948,1.0,0,0,3,6,1360,0,98010,47.3422,-122.053,1670,8475,8588,6805,43,310,-1473,99,359999.0,0.0064636018421265,0.0018603861367196,0.0069146448109658,0.0,0.0084545831941111,0.0018427398225316,0.6526407017797272
4123800180,309000.0,3,2.5,1780,7859,2.0,0,0,3,7,1780,0,98038,47.3772,-122.045,1670,6618,6079,4948,32,-110,-1241,586,342750.0,0.0014120685852818,0.0005275796827244,0.0014761836836919,0.0,0.001344216929245,0.0005643402454922,0.901531728665208
8661000148,270000.0,3,2.0,1510,10215,1.0,0,0,4,7,1510,0,98022,47.2078,-122.003,1370,8902,8705,7532,25,-140,-1313,233,280000.0,0.0035272627039855,0.0005905818413457,0.0037507700256344,0.0,0.0032637697732037,0.0007420310846173,0.9642857142857144
585000095,625000.0,3,2.5,2180,5000,1.0,0,0,4,8,1240,940,98116,47.5828,-122.396,2000,5000,2820,3000,43,-180,0,329,565500.0,0.0035720605873909,0.0030521136192024,0.0026543254802402,0.0065674561587368,0.003587257344461,0.0030845100224984,1.1052166224580018
9320600090,273500.0,3,1.5,1560,8314,1.0,0,0,3,7,1560,0,98031,47.4117,-122.209,1820,8925,6754,7105,58,260,611,271,288400.0,0.0029791118427334,0.0025273720103733,0.0033687047330301,0.0,0.0035137373616465,0.0038797701611115,0.9483356449375868
2522029039,550000.0,3,2.0,3650,843309,2.0,0,0,4,7,3650,0,98070,47.3627,-122.496,1870,273992,839659,272122,29,-1780,-569317,116,466250.0,0.0165534381264229,0.075254553641655,0.0185919998370016,0.0,0.0090922351339524,0.0293336390972726,1.1796246648793565
7436000205,665000.0,3,1.0,1260,24550,1.5,0,2,4,7,1260,0,98136,47.5442,-122.396,2500,12320,23290,9820,83,1240,-12230,263,489950.0,0.0027743770862875,0.0156036482664378,0.0035432074463597,0.0,0.0056846605120742,0.0081420147124619,1.357281355240331
2902200241,562500.0,3,2.25,1300,907,2.0,0,0,3,8,1000,300,98102,47.6371,-122.327,1300,1169,-393,-131,14,0,262,104,710000.0,0.0058111206969768,0.0024190795229052,0.0054868480252833,0.0072367627547943,0.0063955919612328,0.0034025683715406,0.7922535211267606
6453300306,419000.0,7,3.25,4340,8521,2.0,0,0,3,7,2550,1790,98106,47.52,-122.338,1890,8951,4181,7061,34,-2450,430,330,315000.0,0.0088191485254343,0.0046654799925317,0.006484902891758,0.0181009202143796,0.0042012883951078,0.0053199772247204,1.33015873015873
3111300040,435000.0,3,2.25,1740,8491,1.0,0,0,3,8,1240,500,98177,47.7758,-122.379,2080,8494,6751,6414,62,340,3,254,557000.0,0.0029457574321121,0.0028042019104636,0.0026547232665085,0.0040457002297957,0.0037457230325949,0.0028571351686631,0.7809694793536804
3530540090,245000.0,2,1.5,1450,6258,1.0,0,0,4,8,1450,0,98198,47.3785,-122.322,1460,5375,4808,3915,37,10,-883,275,266750.0,0.003013794866572,0.0021563011682204,0.0035679924014065,0.0,0.0030940069509197,0.0020569548801685,0.9184629803186504
5631501202,585000.0,4,2.5,2820,5612,2.0,0,0,3,9,2820,0,98028,47.7477,-122.236,1620,14881,2792,13261,13,-1200,9269,282,442500.0,0.0047080743475059,0.0016721546033862,0.0056120408126712,0.0,0.0027472154766588,0.0052192041178436,1.3220338983050848
9547205225,540000.0,4,1.75,1630,6120,1.0,0,0,5,7,980,650,98115,47.6821,-122.31,1630,4080,4490,2450,102,0,-2040,576,570000.0,0.0015434042194588,0.0019493270521683,0.0012081091243057,0.0026539061415471,0.0016728740900539,0.0013401475016267,0.9473684210526316
9828702518,479000.0,2,2.25,1230,932,2.0,0,0,3,8,1020,210,98112,47.6192,-122.301,1230,1064,-298,-166,16,0,132,268,917500.0,0.0018363361659689,0.0006963403281167,0.001898797800373,0.001583352182764,0.0020114439714734,0.0008099847366598,0.5220708446866485
8682302030,413800.0,3,2.0,1440,4421,1.0,0,0,3,8,1440,0,98053,47.7188,-122.024,1440,4157,2981,2717,13,0,-264,400,635000.0,0.0013739592735571,0.0003136422829242,0.0014156146225125,0.0,0.0014551113311742,0.0003577972428352,0.6516535433070866
2798000020,1395000.0,4,3.5,3560,16782,2.0,0,0,3,10,2560,1000,98040,47.5569,-122.225,3100,18047,13222,14947,6,-460,1265,282,993750.0,0.0040633378494213,0.0043424271067641,0.0036688780255703,0.0056064496596885,0.0037922994301764,0.0049992215984544,1.4037735849056605
7695370160,511000.0,5,2.5,3361,6983,2.0,0,0,3,10,3361,0,98092,47.3427,-122.169,3112,6920,3622,3808,14,-249,-63,351,309780.0,0.0043611006945841,0.0006122421424248,0.0046373524180874,0.0,0.0041624422514639,0.0006525794996488,1.64955775066176
7518508625,900000.0,3,1.0,1560,3825,1.5,0,0,3,8,1390,170,98117,47.6803,-122.387,1700,5100,2265,3400,90,140,1275,548,545000.0,0.0016812192719458,0.0015055836488498,0.0019003401472148,0.0008653601425299,0.0020142657408943,0.0020049021823949,1.651376146788991
6303401050,132500.0,3,0.75,850,8573,1.0,0,0,3,6,600,250,98146,47.503,-122.356,850,8382,7723,7532,75,0,-191,281,312000.0,0.0018593947560692,0.0033858462700201,0.001549194676967,0.0035796105383734,0.0019660543371158,0.0036087964736952,0.4246794871794871
8071000050,270000.0,2,1.0,1040,5700,1.0,0,0,3,6,1040,0,98118,47.519,-122.26,1380,5700,4660,4320,98,340,0,498,370000.0,0.0012310504055955,0.0019777643767856,0.0015656402188885,0.0,0.0017182408699777,0.0020592247488468,0.7297297297297297
3629980440,742500.0,4,2.5,2620,4400,2.0,0,0,3,9,2620,0,98029,47.5524,-121.991,2640,4554,1780,1914,16,20,154,320,574500.0,0.0035888444468796,0.0015822249967096,0.0037741284932296,0.0,0.0037297091109447,0.0020182842190915,1.2924281984334205
9268850040,484000.0,3,2.25,1620,1425,3.0,0,0,3,8,1540,80,98027,47.5405,-122.026,1620,1237,-195,-383,11,0,-188,411,571000.0,0.0015666114484483,0.000105291398934,0.0017720111981902,0.0004848191018726,0.0016583085866604,0.0001056148058126,0.8476357267950964
1423200170,223000.0,2,1.0,910,9869,1.0,0,0,3,6,910,0,98058,47.4572,-122.184,1480,9750,8959,8270,63,570,-119,451,335000.0,0.0009819451578234,0.0011179492535544,0.0011153573678546,0.0,0.0016577450858499,0.001566991288332,0.6656716417910448
8570900023,255000.0,3,1.0,1250,10094,1.0,0,0,4,6,1250,0,98045,47.4987,-121.781,1300,10094,8844,8794,93,50,0,218,404750.0,0.00276968414522,0.0009152392687878,0.0029483565860389,0.0,0.0031117228173059,0.0014269459243475,0.6300185299567634
3629000080,237000.0,3,1.5,960,7400,1.0,0,0,3,7,960,0,98198,47.3798,-122.306,1640,8060,6440,6420,58,680,660,275,266750.0,0.0019953400495925,0.0025497968432136,0.0023622570381725,0.0,0.0034754598626769,0.0030844755970526,0.8884723523898782
3630000130,430000.0,3,2.25,1470,1703,2.0,0,0,3,8,1470,0,98029,47.5478,-121.999,1380,1107,233,-273,15,-90,-596,320,574500.0,0.0020135882965316,0.0006123929930446,0.0021175453759723,0.0,0.0019496206716301,0.0004906105908068,0.7484769364664926
561500290,315000.0,3,1.75,1660,37642,1.0,0,0,4,7,1660,0,98022,47.2559,-122.007,2070,54450,35982,52380,29,410,16808,233,280000.0,0.0038776530388185,0.0021762781861904,0.0041233630745384,0.0,0.0049313893653516,0.0045387095660993,1.125
8965500030,804000.0,5,3.5,2770,9305,2.0,0,0,3,9,2770,0,98006,47.5628,-122.114,2520,9773,6535,7253,35,-250,468,490,760184.5,0.0019595761373146,0.0014140088846258,0.0024575888480473,0.0,0.0018476631094263,0.0016358612659755,1.057637981305854
4037000080,416000.0,3,1.0,1110,12150,1.0,0,0,4,7,1110,0,98008,47.6034,-122.122,1490,8200,11040,6710,63,380,-3950,283,545000.0,0.0018384636406548,0.0042138762424432,0.0022895850694301,0.0,0.0026049861883282,0.0030516351554324,0.763302752293578
8682281170,449000.0,2,1.75,1510,6852,1.0,0,0,3,8,1510,0,98053,47.7073,-122.012,1510,5912,5342,4402,15,0,-940,400,635000.0,0.0014407489604662,0.0004861065194744,0.001484429222218,0.0,0.0015258459097729,0.0005088518882949,0.7070866141732284
4379400580,698000.0,3,2.5,2580,4636,2.0,0,0,3,9,2580,0,98074,47.6201,-122.025,2480,4500,2056,2020,14,-100,-136,435,645000.0,0.0022366147708466,0.0007304893096608,0.0024246092197175,0.0,0.0022013117332578,0.0007828867225543,1.082170542635659
3720800115,982218.0,3,1.75,2340,5500,2.0,0,2,3,9,2340,0,98102,47.6451,-122.319,2830,5500,3160,2670,32,490,0,104,710000.0,0.0104600172545583,0.0146691702050483,0.0128392243791631,0.0,0.0139227117309915,0.0160086621415515,1.383405633802817
2807100155,240000.0,3,2.0,1400,6200,1.0,0,0,3,6,700,700,98133,47.7634,-122.34,1410,7564,4800,6154,72,10,1364,484,375000.0,0.0017930373797064,0.0018050835811926,0.0010590752155218,0.0058409265378325,0.0018790454449139,0.0023243929428676,0.64
3052700385,765000.0,4,2.25,2030,2222,2.0,0,0,3,9,1610,420,98117,47.679,-122.375,1420,2222,192,802,5,-610,0,548,545000.0,0.0021877404628525,0.0008746161745737,0.0022011134079251,0.0021379485874268,0.001682504324747,0.0008735083626042,1.4036697247706422
5393601690,370000.0,4,1.0,1310,6000,1.5,0,0,3,7,1310,0,98144,47.5822,-122.295,1630,6000,4690,4370,80,320,0,340,452500.0,0.0020154342260732,0.0043086207602274,0.0026033334591942,0.0,0.0027221699869903,0.0044971847623387,0.8176795580110497
7525211410,425500.0,3,2.5,1970,2752,2.0,0,0,3,8,1970,0,98052,47.6345,-122.108,1850,2778,782,928,42,-120,26,571,615000.0,0.0014575124036525,0.0004335257839144,0.0016394697771652,0.0,0.0013874420742933,0.0004841021751836,0.691869918699187
3834000820,458000.0,3,2.0,2020,8555,1.0,0,0,4,7,1220,800,98125,47.7278,-122.287,1600,8148,6535,6548,63,-420,-407,402,425000.0,0.0028683077552225,0.0027661886705577,0.002131700660303,0.0060635919202637,0.0023982325026455,0.002768200886857,1.0776470588235294
4356200120,248000.0,1,1.0,790,12000,1.0,0,0,3,6,790,0,98118,47.5146,-122.265,1900,6000,11210,4100,102,1110,-6000,498,370000.0,0.0009351248273274,0.0041637144774434,0.0011892843970403,0.0,0.0023656939514186,0.0021676049987861,0.6702702702702703
5608010650,965000.0,4,2.5,3420,9575,2.0,0,0,3,11,3420,0,98027,47.5527,-122.095,3310,8192,6155,4882,26,-110,-1383,411,571000.0,0.0033072908356131,0.0007074843121357,0.0039352456479289,0.0,0.003388272482621,0.0006994312766507,1.6900175131348512
7203600750,421000.0,3,2.5,1930,4505,1.0,0,3,4,7,1440,490,98198,47.3459,-122.326,1550,4505,2575,2955,47,-380,0,275,266750.0,0.0040114648913682,0.0015522749700915,0.0035433855572588,0.0065569383112538,0.0032847334067983,0.0017240152065412,1.5782567947516402
3758900037,865000.0,4,2.5,2580,10631,2.0,0,2,4,9,2580,0,98033,47.6993,-122.206,4220,10631,8051,6411,28,1640,0,431,678000.0,0.002515823849425,0.0023472981121593,0.0029084743699151,0.0,0.0044359323131389,0.0024841007968703,1.275811209439528
9212900300,492000.0,2,1.0,950,6000,1.0,0,0,3,7,950,0,98115,47.6897,-122.294,1440,6000,5050,4560,78,490,0,576,570000.0,0.0008995300665557,0.0019111049531062,0.001171126191929,0.0,0.0014778764967348,0.001970805149451,0.8631578947368421
7195800009,325000.0,6,3.0,2650,12870,1.0,0,0,4,7,2650,0,98022,47.2069,-121.989,1450,8668,10220,7218,43,-1200,-4202,233,280000.0,0.0061902292487164,0.0007440810864532,0.0065824771973054,0.0,0.0034543548694492,0.000722525886482,1.1607142857142858
2574900080,1550000.0,5,3.25,3370,17458,1.0,0,2,5,10,2000,1370,98040,47.5591,-122.229,4240,15202,14088,10962,38,870,-2256,282,993750.0,0.003846474312514,0.0045173455148306,0.0028663109574768,0.0076808360337732,0.0051868869625638,0.0042111246600379,1.559748427672956
6303401395,245000.0,2,1.75,1220,8382,1.0,0,0,3,6,1220,0,98146,47.5033,-122.359,1100,8382,7162,7282,78,-120,0,281,312000.0,0.00266877835577,0.0033104121585569,0.0031500291764997,0.0,0.0025443056127381,0.0036087964736952,0.7852564102564102
2130700860,375000.0,3,2.0,1540,8885,1.5,0,0,5,6,1540,0,98019,47.7403,-121.984,1730,5000,7345,3270,81,190,-3885,190,401250.0,0.0037324646870061,0.0011738216501858,0.0039805007159731,0.0,0.0043281703848068,0.0007109203190553,0.9345794392523364
7893207925,265000.0,3,1.5,1290,7100,1.0,0,0,3,6,1290,0,98198,47.4227,-122.332,1300,7183,5810,5883,66,10,83,275,266750.0,0.0026812381916399,0.0024464267009212,0.0031742828950444,0.0,0.0027549376960244,0.0027488570984651,0.993439550140581
7200179,175000.0,2,1.0,840,12750,1.0,0,0,3,6,840,0,98055,47.484,-122.211,1480,6969,11910,5489,95,640,-5781,260,297225.0,0.0018065215427693,0.0048620808790947,0.0020357220754671,0.0,0.0031859816806053,0.003527494871238,0.5887795441164101
7202360170,788600.0,4,2.75,3500,7200,2.0,0,0,3,9,3500,0,98053,47.6818,-122.025,3920,7666,3700,3746,15,420,466,400,635000.0,0.0033394843454515,0.0005107949416544,0.0034407299852736,0.0,0.0039611364015298,0.0006598204627315,1.2418897637795276
6204200170,525000.0,4,2.75,2910,6308,1.0,0,0,3,8,1640,1270,98011,47.7352,-122.201,1970,7127,3398,5157,35,-940,819,194,470000.0,0.0066483285508014,0.00286860141129,0.0043143248739243,0.0220581849761181,0.0045128111148017,0.0038601381027098,1.1170212765957446
1502400140,275900.0,3,1.75,1380,8400,1.0,0,0,3,7,1380,0,98003,47.3117,-122.321,1540,8400,7020,6860,53,160,0,276,269500.0,0.0025887442151884,0.0028644130101638,0.0030059203561797,0.0,0.0029672732877966,0.0031146248693896,1.023747680890538
7116500925,206000.0,4,2.0,1700,6025,1.0,0,0,3,6,1700,0,98002,47.3029,-122.221,1320,5956,4325,4636,42,-380,-69,197,235000.0,0.0053025411648747,0.0040728117340241,0.0056730015183621,0.0,0.0045320799156758,0.0039845461691558,0.8765957446808511
7977201709,475000.0,3,1.75,1680,3420,1.0,0,0,3,7,960,720,98115,47.6855,-122.291,1680,4080,1740,2400,28,0,660,576,570000.0,0.0015907479071722,0.0010893298232705,0.0011834538360546,0.0029397114183291,0.0017241892461906,0.0013401475016267,0.8333333333333334
7203600745,550000.0,3,2.75,2330,4780,2.0,0,3,3,8,1730,600,98198,47.3459,-122.326,1100,5336,2450,4236,90,-1230,556,275,266750.0,0.0048428565786984,0.0016470309338596,0.0042569840375402,0.0080289040545965,0.0023311011274052,0.0020420299982472,2.061855670103093
2414600195,210000.0,3,1.0,1520,8600,1.0,0,0,3,6,1040,480,98168,47.5134,-122.335,1320,8600,7080,7280,69,-200,0,264,237000.0,0.0039017378134866,0.0028698340067988,0.003177221763969,0.0077120822622107,0.0033860740011081,0.0033337842987287,0.8860759493670886
1781500385,296500.0,3,1.0,1280,5100,1.0,0,0,3,7,1280,0,98126,47.5259,-122.38,1380,7140,3820,5760,72,100,2040,352,396587.5,0.0023536204382514,0.0028407381908842,0.0029119830376988,0.0,0.0027760232059447,0.004043183922398,0.7476282031077631
2744000100,299950.0,3,2.5,1870,7942,2.0,0,0,3,7,1870,0,98001,47.342,-122.279,1870,7392,6072,5522,30,0,-550,358,260000.0,0.0027372957274765,0.001482278079623,0.0030250774063924,0.0,0.0028508009683576,0.0018435197860399,1.153653846153846
7852140170,695000.0,4,2.5,2830,14538,2.0,0,0,3,8,2830,0,98065,47.5405,-121.882,2270,6939,11708,4669,17,-560,-7599,305,500000.0,0.0035934226398323,0.0027649107004972,0.0037648999574286,0.0,0.0029440182606947,0.002009669234336,1.39
4030500130,243500.0,4,2.5,2300,15188,2.0,0,0,4,7,2300,0,98042,47.3683,-122.164,1820,10125,12888,8305,54,-480,-5063,546,292000.0,0.002124165803147,0.0014640876308694,0.0022801445016793,0.0,0.0017031837370284,0.0012588805474669,0.833904109589041
8898700120,400000.0,3,2.0,2260,11305,1.0,0,0,3,7,1130,1130,98055,47.4544,-122.204,2080,10248,9045,8168,34,-180,-1057,260,297225.0,0.0048604031984033,0.0043110450461306,0.0027385308872355,0.0215846577017114,0.0044775958754453,0.0051872244856432,1.3457818151232233
324069058,568000.0,4,2.0,2340,50233,1.0,0,0,4,7,1170,1170,98075,47.5905,-122.022,2470,62290,47893,59820,54,130,12057,358,739999.5,0.0021645482153114,0.0073780300000425,0.001152508380312,0.01775956284153,0.0023131304333982,0.0115564662036906,0.7675680861946529
1954600050,630000.0,5,1.75,2490,24969,1.0,0,2,4,8,1540,950,98023,47.336,-122.35,2790,15600,22479,12810,61,300,-9369,492,269000.0,0.0025322248493631,0.004834563966631,0.0018270669287835,0.0067642619122212,0.0028769055632548,0.0032517654376521,2.342007434944238
424069096,460000.0,3,1.75,1400,12155,1.0,0,0,4,7,1400,0,98075,47.5926,-122.047,2540,23522,10755,20982,43,1140,11367,358,739999.5,0.0012950288467675,0.0017852796896565,0.0013790698567835,0.0,0.0023786847371787,0.0043639620812844,0.6216220416365146
1612500170,253750.0,4,1.0,1380,7110,1.5,0,0,3,6,1380,0,98030,47.3846,-122.226,1430,7110,5730,5680,81,50,0,253,283000.0,0.0027686381510312,0.0023810847431743,0.0030138901022101,0.0,0.0029365861672416,0.0032768616238024,0.8966431095406361
9272201318,540000.0,3,2.0,1580,1972,2.5,0,2,3,8,1180,400,98116,47.5903,-122.386,1500,1908,392,408,13,-80,-64,329,565500.0,0.0025889246459072,0.0012037536114134,0.0025258903763576,0.0027946621952071,0.0026904430083457,0.0011770490245853,0.9549071618037136
8651410120,225500.0,3,1.0,1100,5200,1.0,0,0,4,6,1100,0,98042,47.3643,-122.081,920,5200,4100,4280,51,-180,0,546,292000.0,0.0010159053841138,0.000501267821999,0.0010905038921075,0.0,0.0008609500209154,0.0006465361824027,0.7722602739726028
1042700050,769995.0,5,2.75,3010,5398,2.0,0,0,3,9,3010,0,98074,47.6067,-122.053,3360,5407,2388,2047,6,350,9,435,645000.0,0.0026093838993211,0.000850556793259,0.0028287107563371,0.0,0.0029824223482847,0.0009406818908558,1.1937906976744186
2346200030,802541.0,5,2.75,2990,6768,2.0,0,0,3,9,2990,0,98006,47.5462,-122.182,2870,6768,3778,3898,6,-120,0,490,760184.5,0.0021152103431663,0.0010284806159212,0.0026527764099861,0.0,0.0021042829857356,0.0011328669853803,1.0557187103920167
3356403820,115000.0,2,1.0,1000,16524,1.0,0,0,3,5,1000,0,98001,47.2841,-122.255,1350,10208,15524,8858,107,350,-6316,358,260000.0,0.0014637945066719,0.0030840044054006,0.0016176884526162,0.0,0.0020580648702047,0.0025458130378647,0.4423076923076923
7936500190,1339000.0,4,3.75,2130,34689,1.5,1,4,3,9,2130,0,98136,47.5489,-122.398,3030,28598,32559,25568,65,900,-6091,263,489950.0,0.0046900184077717,0.0220478596625035,0.0059897078259891,0.0,0.0068898085406339,0.0188997838268658,2.7329319318297784
4142450490,315000.0,3,2.5,1790,6452,2.0,0,0,3,7,1790,0,98038,47.3841,-122.042,1610,3600,4662,1990,16,-180,-2852,586,342750.0,0.001420001554862,0.0004331268752943,0.0014844768504542,0.0,0.0012959217102302,0.0003069847210293,0.9190371991247264
3520069033,230000.0,3,1.0,1530,389126,1.5,0,0,4,7,1530,0,98022,47.1776,-122.011,1768,42148,387596,40380,101,238,-346978,233,280000.0,0.0035739814152966,0.0224973812624078,0.0038004490988216,0.0,0.0042119306270249,0.0035132696196869,0.8214285714285714
2787460720,259950.0,3,2.0,1010,7896,1.0,0,0,3,7,1010,0,98031,47.4046,-122.181,1540,7896,6886,6356,36,530,0,271,288400.0,0.001928783949462,0.0024003042330897,0.0021810203720259,0.0,0.0029731623829317,0.0034324554837127,0.9013522884882108
5042300095,730000.0,4,1.0,1870,4992,1.5,0,0,4,7,1670,200,98199,47.6437,-122.396,2160,5239,3122,3079,80,290,247,316,689900.0,0.0027368390241046,0.002904095053265,0.0033206736791871,0.0011088933244621,0.0034308586676832,0.0031387345849129,1.0581243658501231
1257201130,1015000.0,4,2.5,2700,4590,2.0,0,0,3,8,2700,0,98103,47.6734,-122.329,2080,3570,1890,1490,18,-620,-1020,599,550000.0,0.0027300027300027,0.0022023166067626,0.0032080719843826,0.0,0.0022788526853211,0.0017168612122098,1.8454545454545452
7856600900,825000.0,4,2.5,2810,9800,1.0,0,0,4,8,1710,1100,98006,47.5657,-122.149,2800,9800,6990,7000,47,-10,0,490,760184.5,0.0019878732656513,0.001489230206269,0.0015171396859787,0.0038401117123407,0.0020529590104737,0.0016403806821405,1.0852628539519025
9357000650,535000.0,4,2.5,2340,5600,2.0,0,0,3,7,2340,0,98146,47.5117,-122.379,1310,5600,3260,4290,99,-1030,0,281,312000.0,0.0051188043872966,0.0022116807549414,0.0060418592401716,0.0,0.0030300366842609,0.0024110308103905,1.7147435897435896
7349620030,272000.0,4,2.25,2115,6234,2.0,0,0,3,7,2115,0,98002,47.285,-122.201,2440,6366,4119,3926,22,325,132,197,235000.0,0.0065969850374764,0.0042140926721836,0.0070578813007858,0.0,0.0083774810562492,0.0042588349417136,1.1574468085106382
486000510,1325000.0,4,3.0,3370,7920,1.0,0,3,3,10,1860,1510,98117,47.6773,-122.403,2730,7380,4550,4650,32,-640,-540,548,545000.0,0.0036318647092676,0.0031174437905597,0.0025429012041867,0.0076864342071773,0.0032346738074361,0.002901211393348,2.4311926605504586
2891000680,195000.0,3,1.75,1070,6110,1.0,0,0,4,7,1070,0,98002,47.3249,-122.207,1350,6148,5040,4798,52,280,38,197,235000.0,0.0033374817920093,0.0041302704887779,0.0035706538968514,0.0,0.0046350817319412,0.0041129935943536,0.8297872340425532
8698600080,265000.0,5,2.75,2920,5250,1.5,0,0,5,7,1800,1120,98002,47.3072,-122.221,1220,5250,2330,4030,109,-1700,0,197,235000.0,0.0091078942361377,0.0035489230877388,0.0060067074900305,0.053496369889186,0.0041887405281246,0.0035122342827515,1.127659574468085
5100402668,495000.0,3,1.0,1570,5510,1.0,0,0,4,7,1070,500,98115,47.6942,-122.319,1770,6380,3940,4610,80,200,870,576,570000.0,0.0014865917942026,0.0017550313819359,0.0013190579214359,0.0020414662627285,0.0018165565272365,0.0020956228089163,0.868421052631579
7649400170,675000.0,3,2.25,2070,2833,2.0,0,2,3,8,1490,580,98136,47.5543,-122.398,1940,3794,763,1854,54,-130,961,263,489950.0,0.0045579052131866,0.0018006165188928,0.0041899834087905,0.005885576279098,0.0044112965573695,0.0025073704398604,1.3776916011837943
2675600025,603500.0,3,1.75,2140,7280,1.0,0,0,3,7,1070,1070,98117,47.6993,-122.377,2280,8400,5140,6120,110,140,1120,548,545000.0,0.002306287975618,0.0028655291408175,0.0014628517679999,0.0054466785441588,0.0027014858171994,0.003302191829827,1.1073394495412845
2871000300,755000.0,4,2.5,3110,6930,2.0,0,0,3,9,3110,0,98052,47.7011,-122.112,3090,7000,3820,3910,16,-20,70,571,615000.0,0.0023009459773397,0.0010916910183602,0.0025881984807025,0.0,0.0023174032484143,0.0012198398942712,1.227642276422764
9211010330,576000.0,4,2.5,3340,6924,2.0,0,0,3,8,3340,0,98059,47.495,-122.149,3030,6119,3584,3089,11,-310,-805,465,435000.0,0.002979987687476,0.001032815458819,0.0031564821290188,0.0,0.0027696956899695,0.0010447083617815,1.3241379310344827
5592900020,410000.0,3,3.25,2650,7819,1.0,0,2,4,8,1760,890,98056,47.4821,-122.192,2400,7727,5169,5327,64,-250,-92,404,380000.0,0.0032529666442027,0.002020632730167,0.0024368765888158,0.009631513446242,0.0031115692032438,0.0024419526646105,1.0789473684210529
3530200160,654950.0,4,2.5,2790,45902,2.0,0,0,3,9,2790,0,98077,47.7674,-122.086,2890,42421,43112,39531,33,100,-3481,196,652475.0,0.0049853031832679,0.0042528526688869,0.0053221422099289,0.0,0.0053021685685979,0.0047433088439603,1.0037932487834782
239000115,535000.0,2,1.75,2330,7280,1.0,0,0,3,7,1450,880,98188,47.4282,-122.28,1830,12178,4950,10348,38,-500,4898,135,265000.0,0.0095559556570847,0.0053198991265281,0.007193066875679,0.0208313606666035,0.0082717846262328,0.0092419940789918,2.018867924528302
8798000100,252500.0,4,2.5,2600,11280,1.5,0,0,3,7,1570,1030,98003,47.336,-122.304,1660,11200,8680,9540,59,-940,-80,276,269500.0,0.0048773441735434,0.0038464974707915,0.0034197789559436,0.0139221172431504,0.0031984893881443,0.0041528331591862,0.9369202226345084
6909700437,353250.0,2,1.0,1060,1600,2.0,0,0,3,7,1060,0,98144,47.5888,-122.294,1360,3360,540,2000,41,300,1760,340,452500.0,0.0016308093737692,0.0011489655360606,0.0021065140967525,0.0,0.0022712583940533,0.0025184234669097,0.7806629834254144
7011201306,1120280.0,4,4.0,2530,1774,3.0,0,2,3,9,2100,430,98119,47.6362,-122.369,2160,2400,-756,240,7,-370,626,184,744975.0,0.0068557554473448,0.0026668671076368,0.0071781865166311,0.0056223849372384,0.0062929728469875,0.0034992615100188,1.5037820061075875
5076700145,550000.0,3,1.0,1140,8180,1.0,0,0,3,7,1140,0,98005,47.5851,-122.172,1510,8588,7040,7078,61,370,408,168,765475.0,0.0025540895678883,0.0024432234300945,0.0031412487290342,0.0,0.003500223689792,0.0027830834672268,0.7185081158757635
3630070010,310000.0,2,1.0,1050,2699,1.0,0,0,3,7,1050,0,98029,47.5471,-121.996,1240,2671,1649,1431,15,190,-28,320,574500.0,0.0014382773546654,0.0009705511968453,0.0015125324114088,0.0,0.0017518330672619,0.0011837587064544,0.5395996518711923
8682290670,745000.0,2,2.5,2170,7546,1.0,0,0,3,8,2170,0,98053,47.7242,-122.032,2170,7083,5376,4913,13,0,-463,400,635000.0,0.0020704802941799,0.0005353414763506,0.0021332525908696,0.0,0.0021927719365611,0.0006096410562911,1.1732283464566928
9485300010,311500.0,4,2.5,1940,10133,2.0,0,0,3,8,1940,0,98031,47.3877,-122.171,1940,7265,8193,5325,28,0,-2868,271,288400.0,0.00370479293263,0.0030803296344855,0.0041892866551785,0.0,0.0037454123525243,0.0031581546465518,1.0800970873786409
2524049215,1564350.0,4,3.75,3730,17000,2.0,0,3,4,10,2820,910,98040,47.5355,-122.242,3880,15550,13270,11670,34,150,-1450,282,993750.0,0.0042573736456016,0.0043988357058151,0.0040414984500423,0.0051018691903165,0.0047464908997046,0.0043075245667405,1.574188679245283
3279000420,233000.0,3,1.75,1460,7800,1.0,0,0,2,7,1040,420,98023,47.3035,-122.382,1310,7865,6340,6555,41,-150,65,492,269000.0,0.0014847583454097,0.0015102566758669,0.0012338633804771,0.0029905157927714,0.0013508051210981,0.0016394317414829,0.8661710037174721
1099900020,368500.0,5,2.75,2530,7601,1.0,0,0,3,7,1520,1010,98188,47.4683,-122.263,2400,7776,5071,5376,28,-130,175,135,265000.0,0.0103762093615555,0.00555447160175,0.0075403183800221,0.023908720765079,0.0108482421327644,0.0059012765608671,1.390566037735849
3905050280,533000.0,3,2.5,2060,4812,2.0,0,0,3,8,2060,0,98029,47.5793,-122.002,1930,5264,2752,3334,30,-130,452,320,574500.0,0.002821763191058,0.0017303787918561,0.0029674445404782,0.0,0.002726643403077,0.0023329486449929,0.927763272410792
2767603931,469000.0,3,3.25,1370,1194,3.0,0,0,3,8,1370,0,98107,47.6718,-122.388,1800,2678,-176,878,16,430,1484,264,529975.0,0.0032815157249275,0.0014145612135371,0.0039366684865377,0.0,0.0044831880448318,0.0029444685113391,0.8849474031793952
8019700010,489950.0,3,1.75,2480,10804,1.0,0,0,3,8,1800,680,98177,47.7721,-122.367,2480,10400,8324,7920,44,0,-404,254,557000.0,0.0041985508227805,0.0035680835520727,0.0038536305481575,0.0055021523125222,0.0044660543850171,0.0034982582710262,0.8796229802513466
1089700010,540000.0,4,2.5,2329,9436,2.0,0,0,3,9,2329,0,98011,47.7366,-122.204,2660,10252,7107,7592,25,331,816,194,470000.0,0.0053209474896276,0.0042910784586133,0.0061268674581523,0.0,0.006093440388514,0.0055527060234294,1.148936170212766
4140940130,450000.0,3,2.75,2240,3360,2.0,0,0,3,8,2100,140,98178,47.4999,-122.232,1790,5873,1120,4083,6,-450,2513,258,279500.0,0.0049991073022674,0.0015674697772233,0.006121199755152,0.0013332063612989,0.0042035554094356,0.0027991392396617,1.6100178890876566
3278613060,425000.0,4,2.5,1900,2766,2.0,0,0,3,8,1900,0,98106,47.543,-122.368,1900,2604,866,704,6,0,-162,330,315000.0,0.0038609175572177,0.0015144604693513,0.004831888429153,0.0,0.0042235174342353,0.0015476729631518,1.3492063492063493
7920100025,450000.0,2,1.0,740,5100,1.0,0,0,4,7,740,0,98115,47.6787,-122.301,920,5100,4360,4180,73,180,0,576,570000.0,0.0007006865781592,0.0016244392101403,0.0009122456652921,0.0,0.0009441988729139,0.0016751843770334,0.7894736842105263
2883200083,424950.0,2,1.5,1000,1188,3.0,0,0,3,8,1000,0,98115,47.6823,-122.327,2300,3500,188,1200,15,1300,2312,576,570000.0,0.0009468737542692,0.000378398780715,0.0012327644125569,0.0,0.0023604971822847,0.0011496363371797,0.7455263157894737
3931900295,824500.0,4,2.5,2610,3500,1.5,0,0,5,7,1610,1000,98115,47.6848,-122.326,1820,3900,890,2080,93,-790,400,576,570000.0,0.0024713404986426,0.0011148112226453,0.0019847507042166,0.004082932525457,0.0018678716833731,0.0012810233471432,1.4464912280701754
686800070,895000.0,5,2.5,2550,20875,1.0,0,0,4,9,1610,940,98004,47.6336,-122.192,2510,21673,18325,19163,67,-40,798,315,1150000.0,0.0027811709274932,0.0050648077022926,0.0021133878526141,0.0060617785516218,0.0029814225305269,0.005375845332021,0.7782608695652173
8096800260,272000.0,3,2.5,1528,7616,2.0,0,0,3,7,1528,0,98030,47.3774,-122.186,1850,7340,6088,5490,9,322,-276,253,283000.0,0.0030655645614316,0.0025505402818588,0.0033371188957805,0.0,0.0037990800065713,0.0033828641798467,0.96113074204947
624110810,1070000.0,3,3.25,3730,13264,2.0,0,0,3,9,3730,0,98077,47.7246,-122.059,3730,14933,9534,11203,31,0,1669,196,652475.0,0.0066649393812148,0.001228918953425,0.0071152653917688,0.0,0.0068432833082596,0.0016697350596841,1.639909575079505
8887001192,355000.0,2,1.0,1240,27042,1.0,0,1,3,6,1000,240,98070,47.5026,-122.465,2140,20059,25802,17919,77,900,-6983,116,466250.0,0.005623633774456,0.0024131529956132,0.0050936985854799,0.0099267899243082,0.010405017746876,0.0021475206088213,0.7613941018766756
259700180,517000.0,4,1.0,1650,8250,1.0,0,0,3,7,1650,0,98008,47.6366,-122.118,2240,9776,6600,7536,54,590,1526,283,545000.0,0.0027328513577302,0.0028612739917824,0.003403437265369,0.0,0.0039162208468827,0.0036381445462813,0.9486238532110092
7955050170,455000.0,3,2.25,1790,7500,1.0,0,0,3,7,1390,400,98034,47.7321,-122.198,1940,7192,5710,5252,47,150,-308,543,446000.0,0.001666871533559,0.0014136660035002,0.0015402003368495,0.002333885686279,0.0018674585717792,0.0015598648001499,1.0201793721973094
323059167,259000.0,2,1.0,1210,17389,1.0,0,0,4,5,1210,0,98059,47.5044,-122.148,2140,14419,16179,12279,72,930,-2970,465,435000.0,0.0010795763777981,0.0025938226478053,0.001143515980872,0.0,0.0019561547117276,0.0024617829495878,0.5954022988505747
6381500700,365000.0,4,1.0,1590,7085,1.5,0,0,3,6,1590,0,98125,47.7315,-122.305,1320,7085,5495,5765,76,-270,0,402,425000.0,0.002257727391487,0.0022908762981767,0.0027782000408867,0.0,0.0019785418146825,0.0024070573494578,0.8588235294117647
6073200020,485000.0,3,1.0,1020,9835,1.0,0,0,5,7,1020,0,98006,47.5728,-122.179,1210,9622,8815,8412,65,190,-213,490,760184.5,0.0007215767725851,0.0014945488855771,0.0009049605144434,0.0,0.0008871715723833,0.0016105860126078,0.6380030111111185
8830400135,264950.0,3,1.5,1470,11599,1.0,0,0,3,7,1070,400,98030,47.3632,-122.188,1580,9760,10129,8180,53,110,-1839,253,283000.0,0.0029492015087071,0.0038844165873529,0.0023368568183803,0.009861932938856,0.0032446196812879,0.0044981954217035,0.9362190812720848
7137800310,329950.0,4,2.5,2300,9690,2.0,0,0,3,8,2300,0,98023,47.2793,-122.352,1200,9085,7390,7885,14,-1100,-605,492,269000.0,0.0023390028729057,0.0018762034857885,0.0027287363222091,0.0,0.0012373787368837,0.0018937364744275,1.2265799256505576
8562710520,890000.0,5,3.5,4490,6000,2.0,0,0,3,10,3200,1290,98027,47.5396,-122.073,4530,6000,1510,1470,14,40,0,411,571000.0,0.0043420280268722,0.000443332206038,0.0036821011910446,0.0078177080176958,0.0046371221589949,0.0005122787670782,1.5586690017513134
2326059099,838000.0,4,2.5,3310,42998,2.0,0,0,3,9,3310,0,98052,47.7232,-122.131,3350,42847,39688,39497,19,40,-151,571,615000.0,0.002448916779741,0.0067735253113209,0.002754642112902,0.0,0.0025123951075042,0.0074666399928343,1.36260162601626
6861700156,1045000.0,4,2.25,2630,4000,2.0,0,0,5,9,1810,820,98102,47.6393,-122.317,2370,4700,1370,2330,111,-260,700,104,710000.0,0.0117563441792686,0.0106684874218533,0.0099311949257629,0.0197804848631045,0.0116596561139399,0.0136801294664167,1.471830985915493
461003835,825000.0,3,3.5,2670,3000,2.0,0,0,3,9,1870,800,98117,47.6813,-122.372,1750,5000,330,3250,6,-920,2000,548,545000.0,0.0028774714462149,0.0011808499206665,0.0025565727160372,0.0040722830236701,0.0020735088509206,0.001965590374897,1.5137614678899085
1157200189,356000.0,3,3.5,2100,12384,2.0,0,0,3,9,2100,0,98188,47.4687,-122.263,2400,7776,10284,5376,40,300,-4608,135,265000.0,0.0086126638969433,0.0090496745580939,0.0104175451302937,0.0,0.0108482421327644,0.0059012765608671,1.3433962264150945
2927600675,480000.0,4,1.75,2220,6500,2.0,0,3,4,8,2220,0,98166,47.4519,-122.375,2430,11600,4280,9170,56,210,5100,250,392500.0,0.0042765667259992,0.0019031061327155,0.005181347150259,0.0,0.0051425306329756,0.0036460135713425,1.2229299363057324
1934800180,526000.0,3,2.5,1626,1583,2.5,0,0,3,8,1419,207,98122,47.6031,-122.309,1400,1583,-43,183,13,-226,0,289,574000.0,0.0031452867124209,0.0015631464766006,0.0032833997417706,0.0024413256280221,0.0028300094198884,0.0015396211734383,0.9163763066202092
3329530200,205000.0,3,2.0,1410,8384,1.0,0,0,3,7,1410,0,98001,47.3315,-122.263,1410,9205,6974,7795,35,0,821,358,260000.0,0.0020639502544074,0.0015647720246235,0.0022809407181889,0.0,0.0021495344199915,0.0022956709456842,0.7884615384615384
2268000180,230000.0,3,1.0,1250,9035,1.0,0,0,4,7,1250,0,98003,47.275,-122.302,1350,10425,7785,9075,50,100,1390,276,269500.0,0.0023448770065112,0.0030809489936703,0.002722753945815,0.0,0.0026011811289126,0.0038654719361175,0.8534322820037106
9211010840,530000.0,4,2.5,3010,9000,2.0,0,0,3,8,3010,0,98059,47.4987,-122.147,3250,5531,5990,2281,12,240,-3469,465,435000.0,0.0026855577662583,0.0013424810989848,0.0028446141342355,0.0,0.002970795707063,0.0009443180174887,1.2183908045977012
823069074,523000.0,4,2.5,2660,65340,2.0,0,0,3,8,2660,0,98027,47.4969,-122.06,2850,74052,62680,71202,32,190,8712,411,571000.0,0.0025723373165879,0.0048278877237543,0.0030607466150558,0.0,0.0029173947357915,0.0063225445432791,0.915936952714536
6117501015,387500.0,3,1.0,1560,14333,1.0,0,0,4,7,1560,0,98166,47.432,-122.348,1640,14333,12773,12693,67,80,0,250,392500.0,0.003005154996648,0.0041964954154173,0.0036409466461279,0.0,0.003470679110321,0.0045050269412114,0.9872611464968152
1771110090,316000.0,3,0.75,1270,10092,1.0,0,0,5,7,1270,0,98077,47.7567,-122.073,1300,10375,8822,9075,49,30,283,196,652475.0,0.0022692957142474,0.0009350309166138,0.0024226238733368,0.0,0.0023850585256668,0.0011600817815725,0.4843097436683398
7215730120,606500.0,3,2.5,2170,5500,2.0,0,0,3,8,2170,0,98075,47.5975,-122.018,2170,5862,3330,3692,20,0,362,358,739999.5,0.0020072947124897,0.0008078188640979,0.0021375582780145,0.0,0.002032183417196,0.0010875582739771,0.8195951483751003
5255200220,405000.0,3,1.75,2020,8531,1.0,0,0,3,7,2020,0,98011,47.7691,-122.199,1950,8449,6511,6499,55,-70,-82,194,470000.0,0.00461499095279,0.0038795241977988,0.0053139855154434,0.0,0.0044669957735347,0.0045761620358911,0.8617021276595744
2644900109,439950.0,5,1.75,2190,7500,1.0,0,0,3,7,1290,900,98133,47.7766,-122.355,1790,8820,5310,7030,41,-400,1320,484,375000.0,0.002804822758255,0.0021835688482169,0.0019517243257473,0.0075097626914989,0.0023854548556,0.0027103577149779,1.1732
1086100130,528000.0,5,1.75,2140,8580,1.0,0,0,3,7,1200,940,98033,47.6625,-122.178,1600,9206,6440,7606,58,-540,626,431,678000.0,0.0020867686192905,0.0018944424609469,0.0013527787767046,0.0067896508385941,0.0016818700713323,0.0021511270751564,0.7787610619469026
2487200938,815000.0,5,3.25,3230,5000,2.0,0,1,3,9,2350,880,98136,47.5202,-122.393,1520,5000,1770,3480,18,-1710,0,263,489950.0,0.0071120936418323,0.0031779324371563,0.0066083630944011,0.008929839871735,0.0034562735913411,0.0033043890878498,1.663435044392285
1559900080,289200.0,3,2.25,1760,7023,2.0,0,0,3,7,1760,0,98019,47.7468,-121.98,1760,7082,5263,5322,25,0,59,190,401250.0,0.004265673928007,0.0009278277376764,0.0045491436753979,0.0,0.004403225362578,0.00100694753991,0.7207476635514019
5589300585,325000.0,3,1.0,1050,9083,1.0,0,0,3,7,1050,0,98155,47.7533,-122.307,1440,9071,8033,7631,69,390,-12,442,377225.0,0.0013330963384287,0.0019944012723063,0.0016120860393348,0.0,0.0018951782191378,0.0020882036407166,0.8615547750016568
2459900040,587000.0,5,3.5,3610,52595,2.0,0,0,4,7,3610,0,98014,47.6832,-121.907,1620,60112,48985,58492,31,-1990,7517,123,415000.0,0.0138532856463075,0.0043850456063085,0.0148000557564427,0.0,0.0068415629170397,0.0062307130036904,1.4144578313253011
2212200050,255000.0,4,1.75,1650,7200,1.0,0,0,3,7,1100,550,98031,47.3944,-122.187,1620,7374,5550,5754,43,-30,174,271,288400.0,0.0031509836798142,0.0021887272642155,0.0023753687220084,0.0090819022457067,0.0031276123768502,0.0032055378339536,0.8841886269070736
6625910100,415000.0,3,2.25,2180,11100,1.0,0,0,5,8,1700,480,98056,47.5162,-122.176,2350,11397,8920,9047,41,170,297,404,380000.0,0.0026760253903253,0.0028685283674197,0.0023538012505607,0.0051945241058384,0.0030467448448428,0.0036017774710193,1.0921052631578947
3758900259,1040000.0,4,3.5,3900,8391,2.0,0,0,3,10,3900,0,98033,47.6979,-122.205,3820,12268,4491,8448,14,-80,3877,431,678000.0,0.0038029895398285,0.0018527117354086,0.0043965310242902,0.0,0.0040154647953059,0.0028666116617444,1.5339233038348083
7625703900,689000.0,4,2.5,2020,9600,2.0,0,0,4,7,2020,0,98136,47.5434,-122.395,2250,8550,7580,6300,66,230,-1050,263,489950.0,0.0044478108843657,0.0061016302793402,0.0056803801917831,0.0,0.0051161944608667,0.0056505053402232,1.4062659455046431
2652500225,575000.0,3,2.75,1710,3600,1.0,0,0,3,7,1590,120,98119,47.642,-122.36,1710,3600,1890,1890,111,0,0,184,744975.0,0.0046337319426717,0.0054119061936259,0.0054349126483064,0.0015690376569037,0.0049819368371984,0.0052488922650282,0.7718379811403068
1120069059,475000.0,3,1.5,1790,229125,2.0,0,3,3,7,1790,0,98022,47.2309,-122.009,1970,216928,227335,214958,33,180,-12197,233,280000.0,0.0041813246623405,0.013246898130038,0.0044462770502553,0.0,0.0046931579950447,0.0180821522269018,1.6964285714285714
7305300045,320000.0,3,1.0,1560,7552,1.0,0,0,4,6,910,650,98155,47.7552,-122.327,1200,8152,5992,6952,72,-360,600,442,377225.0,0.0019806002742369,0.0016582316864975,0.0013971412340902,0.004768542293302,0.0015793151826148,0.0018766438186662,0.8483000861554775
3845100620,400950.0,4,2.5,2578,4554,2.0,0,0,3,9,2578,0,98092,47.2603,-122.194,2647,4554,1976,1907,6,69,0,351,309780.0,0.0033451108570776,0.0003992769177435,0.003557005216849,0.0,0.0035404834960234,0.0004294576649422,1.2943056362579894
626059335,527000.0,4,2.25,2330,19436,2.0,0,0,3,8,2330,0,98011,47.7663,-122.215,1910,10055,17106,8145,33,-420,-9381,194,470000.0,0.0053232321386142,0.0088386393515905,0.006129498144051,0.0,0.0043753650910007,0.0054460065417073,1.1212765957446809
2193300390,624000.0,4,3.25,2810,11250,1.0,0,0,3,8,1680,1130,98052,47.692,-122.099,2110,11250,8440,9140,40,-700,0,571,615000.0,0.0020789897737378,0.0017722256791562,0.0013981265104759,0.0075328311445903,0.0015824339333832,0.0019604569729359,1.0146341463414634
8103000110,490000.0,2,1.5,1480,15641,1.0,0,0,4,7,1480,0,98146,47.5008,-122.366,1520,7525,14161,6005,80,40,-8116,281,312000.0,0.0032375343988029,0.0061773033371497,0.0038213468698521,0.0,0.0035157677557836,0.0032398226514622,1.5705128205128205
9834201367,429000.0,3,2.0,1490,1126,3.0,0,0,3,8,1490,0,98144,47.5699,-122.288,1400,1230,-364,-170,6,-90,104,340,452500.0,0.0022923641197321,0.0008085844960026,0.0029610434001522,0.0,0.0023380601115254,0.0009219228762794,0.9480662983425414
7511200190,580000.0,4,2.25,2570,36465,2.0,0,0,4,8,2570,0,98053,47.6555,-122.042,2390,41454,33895,39064,40,-180,4989,400,635000.0,0.0024521356479458,0.002586963548254,0.0025264788749009,0.0,0.0024150806121572,0.0035679881896785,0.9133858267716536
2894700270,275000.0,4,2.25,2670,10050,1.0,0,0,4,8,1420,1250,98032,47.3792,-122.28,2190,10050,7380,7860,58,-480,0,123,250000.0,0.0124356096243234,0.0078595755829185,0.0080344008147561,0.032924195332666,0.0106595797497189,0.0087933356140591,1.1
510002506,459500.0,2,1.5,1170,1079,3.0,0,0,3,7,1170,0,98103,47.6607,-122.333,1170,1116,-91,-54,17,0,37,599,550000.0,0.0011830011830011,0.000517712335228,0.0013901645265658,0.0,0.0012818546354931,0.0005366994713798,0.8354545454545454
9521101520,543000.0,2,1.0,940,3864,1.0,0,0,4,8,940,0,98103,47.6631,-122.345,1440,3956,2924,2516,102,500,92,599,550000.0,0.0009504453948898,0.0018539763330133,0.0011168843204887,0.0,0.0015776672436838,0.0019024938250705,0.9872727272727272
339600290,379950.0,3,2.0,1080,5077,1.0,0,0,3,7,1080,0,98052,47.6836,-122.095,1070,3471,3997,2401,35,-10,-1606,571,615000.0,0.0007990423329668,0.0007997857576067,0.0008987956138774,0.0,0.0008024664970237,0.0006048663247165,0.6178048780487805
1153000040,650000.0,4,2.5,2240,9934,1.0,0,0,4,8,1490,750,98005,47.6147,-122.166,2640,11622,7694,8982,52,400,1688,168,765475.0,0.0050185619579561,0.0029671126594815,0.0041056671984745,0.0089895720963682,0.006119596384802,0.0037663013572554,0.8491459551259022
2564900470,718500.0,4,2.75,2840,8800,2.0,0,0,3,9,2840,0,98033,47.7029,-122.171,1840,7700,5960,5860,12,-1000,-1100,431,678000.0,0.0027693564854135,0.0019430179086635,0.0032015764382011,0.0,0.0019341505820321,0.001799226426103,1.0597345132743363
8078350090,619000.0,3,2.5,2040,7503,2.0,0,0,3,8,2040,0,98029,47.5718,-122.021,2170,7503,5463,5333,33,130,0,320,574500.0,0.0027943674319215,0.0026980532159801,0.0029386343993085,0.0,0.0030657078677083,0.0033252495599129,1.0774586597040905
5363200100,897000.0,4,2.5,2820,6120,2.0,0,0,3,9,2820,0,98115,47.6911,-122.293,1510,6120,3300,4610,6,-1310,0,576,570000.0,0.0026701839870391,0.0019493270521683,0.0034763956434105,0.0,0.001549717715326,0.0020102212524401,1.5736842105263158
1944900090,462000.0,5,1.75,1250,10530,1.0,0,0,4,7,1250,0,98007,47.6101,-122.138,1560,8190,9280,6630,54,310,-2340,139,560000.0,0.0041049555022823,0.0070803672108396,0.0047579171741778,0.0,0.0052649341883226,0.0061408941561781,0.825
2464400280,710000.0,4,3.5,2850,2910,2.0,0,2,3,8,1970,880,98115,47.6855,-122.321,1460,3880,60,2420,115,-1390,970,576,570000.0,0.0026985901996672,0.0009268859022565,0.0024285458927371,0.0035929806224022,0.0014984025591894,0.001274453996645,1.2456140350877194
2115720270,269000.0,2,2.0,1540,5000,1.5,0,0,3,8,1540,0,98023,47.319,-122.394,1590,5000,3460,3410,34,50,0,492,269000.0,0.0015661149670759,0.0009681132537608,0.0018270669287835,0.0,0.001639526826371,0.001042232512068,1.0
4363700365,429000.0,4,2.5,2100,7920,1.5,0,0,4,6,1400,700,98126,47.5293,-122.371,1230,7920,5820,6690,104,-870,0,352,396587.5,0.0038614085315063,0.0044114993081966,0.003184981447483,0.0067126965861143,0.0024742815531246,0.0044848762836684,1.081728496233492
4022900077,615000.0,4,2.75,2750,15450,1.0,0,0,3,8,1800,950,98155,47.7749,-122.283,2750,10620,12700,7870,42,0,-4830,442,377225.0,0.0034914427911228,0.0033924363819369,0.0027635760674312,0.0069694079671337,0.0036192639601591,0.0024447935910495,1.6303267280800584
824059140,949880.0,4,2.25,2290,10687,2.0,0,0,3,9,2290,0,98004,47.5878,-122.202,2290,10300,8397,8010,42,0,-387,315,1150000.0,0.0024976005584154,0.0025929389180551,0.0030059988711095,0.0,0.0027201026274528,0.0025548473639928,0.8259826086956522
809002030,825000.0,2,2.0,1830,3600,1.0,0,0,4,7,1230,600,98109,47.6359,-122.351,2020,3600,1770,1580,94,190,0,109,736000.0,0.008170700671069,0.0091208974963136,0.0068918759910573,0.0131868131868131,0.0096103525381797,0.0091597459697117,1.1209239130434785
1926059099,708000.0,5,3.25,3060,11778,2.0,0,0,3,8,3060,0,98034,47.7212,-122.222,1840,10403,8718,8563,16,-1220,-1375,543,446000.0,0.0028495122305534,0.0022200210918967,0.0033906568566616,0.0,0.0017711978206565,0.0022562949827529,1.5874439461883407
4240400155,600000.0,3,1.0,1440,4300,1.5,0,0,3,8,1440,0,98117,47.6847,-122.372,1640,4500,2860,2860,91,200,200,548,545000.0,0.0015518947125653,0.0016925515529554,0.0019686977064671,0.0,0.0019431740088627,0.0017690313374073,1.1009174311926606
1118000465,1810000.0,3,3.5,3780,8295,2.0,0,0,3,9,2430,1350,98112,47.6394,-122.29,3780,9127,4515,5347,69,0,832,268,917500.0,0.0056433745588314,0.0061975783494941,0.0045236065244181,0.0101786926034833,0.0061815107416014,0.0069480551611785,1.9727520435967305
2341300115,235000.0,2,1.0,720,6321,1.0,0,0,3,6,720,0,98118,47.551,-122.289,920,5684,5601,4764,80,200,-637,498,370000.0,0.0008522656654123,0.0021932366009933,0.0010839047669228,0.0,0.0011454939133184,0.00205344446885,0.6351351351351351
3530400080,255000.0,2,2.0,1360,5433,1.0,0,0,3,8,1360,0,98198,47.3804,-122.32,1160,5264,4073,4104,46,-200,-169,275,266750.0,0.0028267317369227,0.0018720332769162,0.0033465308040778,0.0,0.002458252097991,0.002014476370085,0.9559512652296156
2525300200,215000.0,3,1.0,1160,10384,1.0,0,0,4,6,1160,0,98038,47.3634,-122.027,1200,9880,9224,8680,51,40,-504,586,342750.0,0.0009202244713072,0.0006970845432511,0.0009620073444284,0.0,0.0009659043802958,0.0008425025121583,0.6272793581327498
164000261,700000.0,4,3.25,2780,7875,2.0,0,0,3,9,2780,0,98133,47.7294,-122.352,1000,7500,5095,6500,14,-1780,-375,484,375000.0,0.0035604599397027,0.0022927472906277,0.0042060415702151,0.0,0.0013326563439106,0.0023047259481104,1.8666666666666667
2998800040,589000.0,3,2.0,2250,8800,1.0,0,0,4,7,1250,1000,98116,47.5737,-122.409,2250,4800,6550,2550,95,0,-4000,329,565500.0,0.003686759780564,0.0053717199697962,0.0026757313308873,0.0069866554880178,0.0040356645125186,0.0029611296215984,1.0415561450044208
7568700135,265000.0,2,1.0,1600,7936,1.0,0,0,3,7,1600,0,98155,47.7411,-122.322,1580,7440,6336,5860,73,-20,-496,442,377225.0,0.0020313848966532,0.0017425485519127,0.0024565120599388,0.0,0.0020794316571096,0.0017127367530516,0.7024985088475048
2759800110,485000.0,3,2.5,1840,8250,1.0,0,1,3,8,1340,500,98177,47.7767,-122.378,1970,7920,6410,5950,62,130,-330,254,557000.0,0.0031150538362565,0.0027246102651425,0.0028688138525172,0.0040457002297957,0.0035476319106789,0.0026640582217815,0.8707360861759426
2561360120,475000.0,3,2.0,1230,11502,1.0,0,0,4,7,1230,0,98052,47.7017,-122.127,1660,11727,10272,10067,36,430,225,571,615000.0,0.0009100204347678,0.0018119235343693,0.001023628338027,0.0,0.00124494802342,0.0020435803485884,0.7723577235772358
3876312290,405000.0,3,1.75,1520,7252,1.0,0,0,3,7,1140,380,98072,47.7358,-122.175,1910,7820,5732,5910,45,390,568,272,517500.0,0.0023584283557565,0.0008657559038714,0.0020125306513714,0.004868923455398,0.0029800911190164,0.0011984872699808,0.782608695652174
1424059142,799000.0,4,3.5,3500,8547,2.0,0,0,3,9,2500,1000,98006,47.5613,-122.126,2350,10270,5047,7920,26,-1150,1723,490,760184.5,0.0024759987294589,0.0012988214870389,0.002218040476577,0.0034910106475824,0.0017230191695047,0.0017190520005697,1.0510606306758423
9211010440,535000.0,4,2.5,3250,6933,2.0,0,0,3,8,3250,0,98059,47.4956,-122.151,3030,5308,3683,2278,11,-220,-1625,465,435000.0,0.002899688618053,0.001034157939918,0.0030714272213506,0.0,0.0027696956899695,0.0009062448086838,1.2298850574712643
774100355,370000.0,2,2.0,2100,58488,2.0,0,0,3,9,2100,0,98014,47.72,-121.402,1440,59346,56388,57906,15,-660,858,123,415000.0,0.0080586980213977,0.0048763674764097,0.0086094507170442,0.0,0.0060813892595908,0.0061513157758352,0.891566265060241
620069061,450000.0,3,2.5,2880,426452,2.0,0,3,3,7,2880,0,98092,47.2485,-122.101,1460,320890,423572,319430,41,-1420,-105562,351,309780.0,0.0037369741149664,0.0373896442963458,0.0039736908551299,0.0,0.001952816737512,0.0302610167113161,1.452643811737362
6669240130,335000.0,3,2.5,2588,5701,2.0,0,0,3,8,2588,0,98042,47.3449,-122.151,2389,5702,3113,3313,12,-199,1,546,292000.0,0.002390148303715,0.0005495630486954,0.0025656582479766,0.0,0.0022356626086598,0.0007089517907808,1.1472602739726028
9349900105,795000.0,2,1.0,1380,5000,1.5,0,2,3,5,1380,0,98106,47.5708,-122.359,1500,5000,3620,3500,115,120,0,330,315000.0,0.0028042453836634,0.002737636423267,0.003509476859069,0.0,0.0033343558691332,0.0029717222794774,2.523809523809524
2061100435,499950.0,3,1.0,1440,5580,1.5,0,0,3,7,1440,0,98115,47.6898,-122.326,2010,5580,4140,3570,112,570,0,576,570000.0,0.0013634982061476,0.0017773276063888,0.0017751807540819,0.0,0.0020628692766923,0.0018328487889895,0.8771052631578947
1972201820,610000.0,4,2.0,2130,2620,1.5,0,0,5,7,1650,480,98103,47.6515,-122.346,1330,2719,490,1389,101,-800,99,599,550000.0,0.0021536688203354,0.0012570957537512,0.0019604884349004,0.0032568206645271,0.0014571509959024,0.0013076038196074,1.1090909090909091
7518503065,335000.0,1,1.0,720,5100,1.0,0,0,3,6,720,0,98117,47.6821,-122.38,1320,5100,4380,3780,113,600,0,548,545000.0,0.0007759473562826,0.0020074448651331,0.0009843488532335,0.0,0.0015640181046944,0.0020049021823949,0.6146788990825688
1025069255,1175000.0,4,3.5,4150,49503,2.0,0,0,3,11,4150,0,98053,47.6746,-122.018,3330,60137,45353,56807,17,-820,10634,400,635000.0,0.003959674295321,0.0035119280551,0.0040797226968245,0.0,0.0033649449533404,0.0051760531133954,1.8503937007874016
8032700175,420000.0,4,1.0,1510,1501,1.5,0,0,3,7,1510,0,98103,47.6526,-122.342,1560,1602,-9,42,114,50,101,599,550000.0,0.001526779304557,0.0007201911169391,0.0017941439616362,0.0,0.0017091395139908,0.0007704234347227,0.7636363636363637
9477100620,245000.0,3,1.5,1330,7125,2.0,0,0,3,7,1330,0,98034,47.7308,-122.194,1570,7350,5795,5780,52,240,225,543,446000.0,0.0012385134858287,0.0013429827033252,0.0014737168690718,0.0,0.0015112937926254,0.0015941332426448,0.5493273542600897
1788800630,185000.0,3,1.0,840,12091,1.0,0,0,3,6,840,0,98023,47.3281,-122.343,840,9324,11251,8484,61,0,-2767,492,269000.0,0.0008542445274959,0.0023410914702445,0.0009965819611546,0.0,0.0008661651158186,0.0019435551885044,0.6877323420074349
7964410100,700000.0,4,3.5,5360,25800,1.0,0,0,3,9,3270,2090,98074,47.6099,-122.054,2650,21781,20440,19131,49,-2710,-4019,435,645000.0,0.0046466105316814,0.0040652770037206,0.0030730512203396,0.0233676207513416,0.0023522081020698,0.0037893457119902,1.0852713178294573
7663700551,336000.0,3,2.0,1060,11765,1.0,0,0,4,6,1060,0,98125,47.7333,-122.302,1500,9151,10705,7651,69,440,-2614,402,425000.0,0.0015051515943247,0.003804115687798,0.0018521333605911,0.0,0.0022483429712302,0.0031089600289186,0.7905882352941176
5350200870,925000.0,4,2.75,3010,3400,2.0,0,2,3,9,2240,770,98122,47.6142,-122.284,1940,5080,390,3140,97,-1070,1680,289,574000.0,0.0058224557222553,0.0033573581935832,0.0051830975486725,0.0090812595824979,0.0039215844818454,0.0049407931529165,1.6114982578397212
7853310450,589500.0,4,2.5,2630,6326,2.0,0,0,3,9,2630,0,98065,47.5222,-121.874,3240,6229,3696,2989,12,610,-97,305,500000.0,0.0033394705098089,0.0012031108193249,0.0034988292890591,0.0,0.0042020348742956,0.0018040394380572,1.179
9320990140,339950.0,3,2.5,1730,4286,2.0,0,0,3,7,1730,0,98148,47.432,-122.329,1780,4343,2556,2563,21,50,57,56,279000.0,0.0190381864201606,0.0085205190240566,0.0206443914081145,0.0,0.0197295499889159,0.0087964482036449,1.2184587813620071
40000362,78000.0,2,1.0,780,16344,1.0,0,0,1,5,780,0,98168,47.4739,-122.28,1700,10387,15564,8687,78,920,-5957,264,237000.0,0.0020022075621839,0.0054540194194325,0.0023829163229768,0.0,0.004360852880215,0.0040265136640576,0.3291139240506329
2112700920,285000.0,3,1.75,1630,4000,1.0,0,0,3,7,1100,530,98106,47.5351,-122.353,1300,4000,2370,2700,52,-330,0,330,315000.0,0.0033122608517184,0.0021901091386136,0.0027974090905623,0.0053594903428051,0.0028897750865821,0.0023773778235819,0.9047619047619048
5559600140,253000.0,3,2.0,1490,7651,1.0,0,0,3,7,1490,0,98003,47.3211,-122.325,1590,7795,6161,6205,32,100,144,276,269500.0,0.0027950933917614,0.0026090028500909,0.0032455227034115,0.0,0.0030636133296081,0.0028902977210586,0.9387755102040816
7229900885,313000.0,3,1.0,1510,10369,1.0,0,0,4,7,1010,500,98059,47.4808,-122.099,1510,16057,8859,14547,52,0,5688,465,435000.0,0.0013472399425415,0.0015466873905971,0.0009545050749428,0.0079782990266475,0.0013802773900508,0.002741441765832,0.7195402298850575
3756500610,355500.0,3,1.0,1120,10032,1.0,0,0,3,7,1120,0,98034,47.7182,-122.194,1210,9918,8912,8708,58,90,-114,543,446000.0,0.0010429587249084,0.0018909196462819,0.00124102473185,0.0,0.0011647550885839,0.002151103877626,0.797085201793722
7852050220,345000.0,3,2.5,1540,3237,2.0,0,0,3,7,1540,0,98065,47.5299,-121.878,1780,3411,1697,1631,21,240,174,305,500000.0,0.0019554314011808,0.0006156291056204,0.0020487441464452,0.0,0.0023085253321747,0.0009878918804323,0.69
3331001115,299000.0,3,2.5,1590,3121,2.0,0,0,3,7,1590,0,98118,47.5515,-122.284,1090,4900,1531,3810,26,-500,1779,498,370000.0,0.0018820866777855,0.0010829127403417,0.0023936230269546,0.0,0.0013571612668664,0.0017702107490086,0.8081081081081081
3756600240,379000.0,3,1.0,1140,10320,1.0,0,0,4,7,1140,0,98034,47.7168,-122.196,1140,10412,9180,9272,57,0,92,543,446000.0,0.0010615829878532,0.0019452044208163,0.0012631858877759,0.0,0.0010973725627981,0.0022582469826419,0.8497757847533632
8731800210,235000.0,3,2.5,2350,9051,1.0,0,0,4,8,1570,780,98023,47.3126,-122.364,2270,8748,6701,6478,54,-80,-303,492,269000.0,0.0023898507614471,0.0017524786119579,0.0018626591416819,0.0055538150437184,0.0023407081106051,0.0018234900031141,0.8736059479553904
4222300040,284850.0,3,1.5,1590,8256,1.0,0,1,3,7,1090,500,98003,47.3488,-122.304,1950,7840,6666,5890,51,360,-416,276,269500.0,0.0029826835522823,0.0028153087871325,0.0023742414407506,0.0067583093413351,0.0037572616306515,0.0029069832114303,1.0569573283858995
1545801410,276900.0,3,2.5,1620,7320,2.0,0,0,3,7,1620,0,98038,47.3617,-122.054,1550,7686,5700,6136,31,-70,366,586,342750.0,0.001285141071998,0.0004913962689328,0.0013434930154949,0.0,0.0012476264912155,0.0006554123793976,0.8078774617067833
2025079037,510000.0,3,2.25,2750,219542,2.0,0,0,3,7,1870,880,98014,47.6367,-121.948,2430,219542,216792,217112,39,-320,0,123,415000.0,0.0105530569327827,0.0183040532845363,0.007666510876606,0.0527894421115776,0.0102623443755595,0.0227559088743711,1.2289156626506024
1773600264,705000.0,5,3.5,3250,4800,2.0,0,0,3,9,2410,840,98106,47.5618,-122.362,1330,4920,1550,3590,10,-1920,120,330,315000.0,0.0066042010847146,0.0026281309663363,0.0061288690075046,0.0084942865810496,0.0029564622039647,0.0029241747230057,2.238095238095238
3816300065,375000.0,3,1.0,1520,10798,1.0,0,0,3,7,1520,0,98028,47.7635,-122.262,1670,9876,9278,8206,67,150,-922,282,442500.0,0.0025376854639039,0.0032173780127163,0.0030249297997377,0.0,0.0028320060777902,0.0034638034989465,0.847457627118644
3832150190,263000.0,3,1.75,1570,7775,2.0,0,0,3,7,1570,0,98031,47.3876,-122.216,1580,8622,6205,7042,38,10,847,271,288400.0,0.0029982087135202,0.0023635214554549,0.0033902989941393,0.0,0.0030503873798909,0.0037480535942973,0.9119278779472956
2473410690,324000.0,4,1.75,2110,7208,1.0,0,0,3,8,1170,940,98058,47.4464,-122.129,1820,7208,5098,5388,45,-290,0,451,335000.0,0.0022768178934147,0.0008165141574243,0.0014340309015274,0.0084799278304014,0.002038578416383,0.0011584485339792,0.9671641791044776
7578200025,487500.0,2,1.0,1190,5000,1.0,0,0,3,7,1190,0,98116,47.5717,-122.382,1600,5000,3810,3400,95,410,0,329,565500.0,0.0019498862839427,0.0030521136192024,0.0025472962270047,0.0,0.0028698058755688,0.0030845100224984,0.8620689655172413
6744700424,537000.0,3,3.0,2410,7479,2.0,0,2,3,7,2410,0,98155,47.7394,-122.288,2610,7479,5069,4869,78,200,0,442,377225.0,0.003059773500584,0.0016422026990619,0.0037001212902829,0.0,0.0034350105221874,0.001721714808612,1.4235535820796608
1081300370,385000.0,4,2.0,1850,11700,1.0,0,0,4,8,1850,0,98059,47.4702,-122.12,2110,11700,9850,9590,51,260,0,465,435000.0,0.001650591982584,0.0017452254286803,0.0017483508798457,0.0,0.001928731982124,0.0019975629731727,0.8850574712643678
6679000170,310000.0,3,2.5,1670,4220,2.0,0,0,3,7,1670,0,98038,47.3834,-122.028,1670,4238,2550,2568,18,0,18,586,342750.0,0.0013248059198992,0.0002832912916525,0.0013849588493065,0.0,0.001344216929245,0.0003613892354784,0.9044493070751276
3592500866,1206500.0,3,2.75,3150,5520,1.5,0,0,4,8,2130,1020,98112,47.6345,-122.302,3160,6200,2370,3040,95,10,680,268,917500.0,0.0047028121323595,0.0041242474369147,0.0039651365831319,0.0076905677448541,0.0051676121543546,0.0047198358715138,1.3149863760217984
1422059039,455000.0,4,2.75,3030,117378,1.0,0,0,4,8,1680,1350,98042,47.401,-122.135,2060,110957,114348,108897,61,-970,-6421,546,292000.0,0.0027983575580589,0.011314964309731,0.0016654968534005,0.0182260024301336,0.0019277793946585,0.0137957144597817,1.5582191780821917
2680700010,775000.0,4,2.5,2070,8473,1.0,0,0,4,8,1250,820,98033,47.6608,-122.19,2070,9499,6403,7429,44,0,1026,431,678000.0,0.0020185098326782,0.0018708171295575,0.0014091445590673,0.0059228869017523,0.0021759194047861,0.0022195911456562,1.1430678466076696
5015001680,427000.0,4,1.0,1860,4736,1.5,0,0,1,7,1860,0,98112,47.6251,-122.3,1800,4000,2876,2200,119,-60,-736,268,917500.0,0.0027768985924408,0.0035384847574688,0.0034625136359744,0.0,0.0029435765436197,0.0030450554009767,0.4653950953678474
3362900810,532170.0,3,2.0,1360,3090,2.0,0,0,3,8,1360,0,98103,47.6838,-122.353,1500,3090,1730,1590,30,140,0,599,550000.0,0.0013751124862235,0.0014826052973631,0.0016159177402816,0.0,0.0016434033788373,0.0014860227298958,0.9675818181818182
3271300955,868000.0,4,2.5,2020,4350,2.0,0,0,5,9,1730,290,98199,47.6503,-122.41,1620,5800,2330,4180,77,-400,1450,316,689900.0,0.0029563715661451,0.0025306116750205,0.0034399793203555,0.0016078953204701,0.0025731440007624,0.0034748350052481,1.2581533555587767
4137020360,265000.0,3,2.5,1780,6527,2.0,0,0,3,8,1780,0,98092,47.2578,-122.217,2040,8840,4747,6800,31,260,2313,351,309780.0,0.0023096576127223,0.000572261844996,0.0024559617090733,0.0,0.0027285932496743,0.0008336420197825,0.8554458002453355
8651610680,670000.0,4,2.5,2570,9086,2.0,0,0,3,9,2570,0,98074,47.6373,-122.064,2760,6733,6516,3973,21,190,-2353,435,645000.0,0.0022279457213472,0.0014316708083645,0.0024152115095635,0.0,0.0024498469289482,0.0011713725117685,1.0387596899224807
9187200095,432500.0,6,2.0,3080,5500,2.0,0,0,1,7,3080,0,98122,47.6031,-122.296,1830,5000,2420,3170,120,-1250,-500,289,574000.0,0.0059578616692845,0.0054310206072671,0.0071267591294247,0.0,0.0036992265988542,0.0048629853867289,0.7534843205574913
3352401981,199000.0,4,2.0,2030,8120,2.0,0,0,3,7,2030,0,98178,47.4994,-122.261,1520,9440,6090,7920,70,-510,1320,258,279500.0,0.0045304409926798,0.0037880519616231,0.0059171597633136,0.0,0.0035694995655543,0.0044992123995243,0.7119856887298748
4233400280,264950.0,4,2.5,1990,9656,2.0,0,0,3,7,1990,0,98010,47.3125,-121.998,1500,9656,7666,8156,26,-490,0,99,359999.0,0.0094577703425233,0.0018057789039168,0.0101177523336926,0.0,0.0075939370006986,0.0020995275193351,0.735974266595185
8825900095,740000.0,3,1.5,1630,4080,1.5,0,0,4,8,1630,0,98115,47.6756,-122.308,1950,4080,2450,2130,93,320,0,576,570000.0,0.0015434042194588,0.0012995513681122,0.0020094059924678,0.0,0.0020012910893283,0.0013401475016267,1.2982456140350878
4123400320,627000.0,4,2.25,1990,7712,1.0,0,0,3,8,1210,780,98027,47.5688,-122.087,1720,7393,5722,5673,47,-270,-319,411,571000.0,0.001924417766921,0.0005698296621609,0.0013922945128637,0.0047269862432579,0.001760673314232,0.0006312128208348,1.0980735551663747
2832100910,435000.0,4,2.75,2230,9640,1.0,0,0,3,8,1320,910,98125,47.7269,-122.325,2100,9600,7410,7500,22,-130,-40,402,425000.0,0.003166498165419,0.0031170144692199,0.0023064302226229,0.0068973358093,0.0031476801597222,0.0032615032540289,1.0235294117647058
2620069077,215000.0,3,1.0,880,7648,1.0,0,2,4,6,880,0,98022,47.1963,-121.997,1020,7566,6768,6546,80,140,-82,233,280000.0,0.0020556232976869,0.0004421703301627,0.0021858792202372,0.0,0.0024299599771297,0.0006306680730414,0.7678571428571429
7986400945,775000.0,2,1.0,1010,3600,1.0,0,0,3,7,1010,0,98107,47.6641,-122.357,1540,3600,2590,2060,107,530,0,264,529975.0,0.0024192196220268,0.0042650086840315,0.0029022154535789,0.0,0.0038356164383561,0.0039582100973939,1.4623331289211756
7915100490,589000.0,4,1.75,1920,4862,1.0,0,0,5,7,1060,860,98116,47.5747,-122.384,1840,4862,2942,3022,101,-80,0,329,565500.0,0.0031460350127479,0.0029678752833124,0.0022690201685924,0.0060085237196953,0.0033002767569041,0.0029993775458774,1.0415561450044208
4318200360,286000.0,2,1.0,1170,6543,1.0,0,0,3,7,1170,0,98136,47.537,-122.385,1550,7225,5373,5675,107,380,682,263,489950.0,0.0025762072944098,0.0041586423872628,0.0032901212001912,0.0,0.003524489517486,0.004774842231943,0.5837330339830595
3334000055,585000.0,2,1.75,1280,7110,1.0,0,0,4,7,1000,280,98118,47.5569,-122.273,1550,6835,5830,5285,65,270,-275,498,370000.0,0.001515138960733,0.0024670008278852,0.0015054232873928,0.0015508856664931,0.0019299082235257,0.0024692633611172,1.5810810810810811
8564850300,535000.0,3,3.0,2640,5978,2.0,0,0,3,9,2640,0,98045,47.4759,-121.735,2680,6060,3338,3380,8,40,82,218,404750.0,0.0058495729147048,0.0005420349067578,0.0062269291097142,0.0,0.006414936269523,0.0008566764713241,1.3218035824583076
9542890010,400000.0,2,2.5,1340,1240,2.0,0,0,3,8,1150,190,98052,47.6858,-122.102,1280,1312,-100,32,12,-60,72,571,615000.0,0.0009914043760885,0.0001953386526358,0.0009570508851472,0.0012665822278514,0.0009599599216732,0.0002286328487548,0.6504065040650406
795000865,235000.0,3,1.0,1020,6173,1.0,0,0,3,6,780,240,98168,47.5042,-122.329,1330,5909,5153,4579,72,310,-264,264,237000.0,0.0026182714274713,0.0020599401539499,0.0023829163229768,0.0038560411311053,0.0034117260768741,0.0022906199326963,0.9915611814345991
3424069145,343000.0,3,1.0,1400,5662,1.5,0,0,5,5,1400,0,98027,47.5271,-122.036,1250,14375,4262,13125,100,-150,8713,411,571000.0,0.0013538617455726,0.0004183578250979,0.001610919271082,0.0,0.0012795590946454,0.0012273345461248,0.6007005253940455
5710610800,575000.0,3,1.75,2680,8625,1.0,0,0,5,8,1590,1090,98027,47.5316,-122.056,2620,14275,5945,11655,46,-60,5650,411,571000.0,0.0025916781986676,0.0006372900461796,0.0018295440293003,0.0066056602630143,0.0026819558623767,0.0012187965666735,1.0070052539404553
1433100010,312000.0,4,1.0,1730,8706,1.0,0,0,4,7,1010,720,98058,47.4586,-122.175,1369,8418,6976,7049,58,-361,-288,451,335000.0,0.0018667748604774,0.0009862059176659,0.0012379241115749,0.0064952638700947,0.0015334142044111,0.0013529161707875,0.9313432835820896
7234600903,419000.0,2,2.25,1180,1253,2.0,0,0,3,8,840,340,98122,47.6124,-122.309,1310,1963,73,653,12,130,710,289,574000.0,0.0022825573927778,0.0012372852401646,0.0019436615807521,0.0040099068286354,0.0026480802428956,0.0019092080628297,0.7299651567944251
2206700295,453000.0,3,1.0,1210,9473,1.0,0,0,5,7,1210,0,98006,47.5637,-122.139,1700,11465,8263,9765,65,490,1992,490,760184.5,0.0008559881321843,0.0014395385453047,0.0010735315906632,0.0,0.0012464393992162,0.0019190780123205,0.5959079670790446
9477730080,377000.0,3,1.75,1680,7389,1.0,0,0,3,8,1150,530,98056,47.5199,-122.184,2100,10348,5709,8248,41,420,2959,404,380000.0,0.0020622580989662,0.0019095095591769,0.0015922773165558,0.0057356203668632,0.0027226230528383,0.0032702635140921,0.9921052631578948
8155000040,230000.0,3,1.0,1020,12289,1.0,0,0,4,7,1020,0,98058,47.4235,-122.155,1300,9894,11269,8594,53,280,-2395,451,335000.0,0.0011006418252526,0.0013920841399261,0.0012501807859469,0.0,0.0014561274402735,0.0015901345442827,0.6865671641791045
5366200210,454000.0,3,2.5,1590,4094,2.0,0,0,3,7,1590,0,98122,47.61,-122.293,1940,3924,2504,1984,29,350,-170,289,574000.0,0.0030756493682345,0.0040426542483911,0.0036790737064238,0.0,0.0039215844818454,0.0038164709315048,0.7909407665505227
6205500280,576000.0,3,1.75,1500,13891,1.0,0,0,4,7,1500,0,98005,47.5866,-122.175,2020,13891,12391,11871,69,520,0,168,765475.0,0.0033606441682741,0.0041489995925969,0.0041332220118871,0.0,0.004682418445947,0.0045016083422505,0.7524739540807995
3447000090,653000.0,3,2.25,2800,17300,1.0,0,0,4,8,1420,1380,98006,47.5716,-122.128,2140,12650,14500,10510,49,-660,-4650,490,760184.5,0.0019807989835671,0.0026289472008626,0.0012598469906957,0.0048175946936638,0.0015690472437192,0.0021174301662324,0.8590019922795058
7230300060,370000.0,4,2.5,2190,17600,1.0,0,0,4,7,1110,1080,98059,47.4712,-122.112,1820,17600,15410,15780,54,-370,0,465,435000.0,0.0019539440226264,0.0026252963713481,0.0010490105279074,0.0172331258975586,0.0016636455959553,0.0030048810536615,0.8505747126436781
7454000585,289000.0,2,1.0,710,6300,1.0,0,0,3,6,710,0,98126,47.5155,-122.374,740,6300,5590,5560,78,30,0,352,396587.5,0.0013055238368426,0.0035091471769746,0.0016152405912235,0.0,0.0014885921539123,0.0035675152256453,0.7287168657610237
1099900030,325000.0,5,2.75,2400,7904,1.0,0,0,3,7,1450,950,98188,47.4683,-122.263,2400,7475,5504,5075,28,0,-429,135,265000.0,0.0098430444536495,0.0057758904802305,0.007193066875679,0.0224884007196288,0.0108482421327644,0.0056728449450208,1.2264150943396226
5045700330,460000.0,4,2.5,2200,6400,2.0,0,0,3,8,2200,0,98059,47.4856,-122.156,2600,5870,4200,3270,10,400,-530,465,435000.0,0.0019628661414512,0.0009546532259447,0.0020791199652219,0.0,0.0023766365656504,0.0010021961241473,1.057471264367816
1472800160,406250.0,4,3.25,2550,11524,2.0,0,0,3,8,2550,0,98019,47.7324,-121.963,2370,14001,8974,11631,30,-180,2477,190,401250.0,0.0061803798388738,0.0015224671577649,0.0065910888478776,0.0,0.0059293432439261,0.0019907190774187,1.0124610591900312
4232901525,665000.0,2,1.0,1110,3200,1.0,0,0,3,7,1110,0,98119,47.6338,-122.358,1170,3600,2090,2430,95,60,400,184,744975.0,0.0030078610855939,0.004810583283223,0.0037941843016479,0.0,0.0034086936254515,0.0052488922650282,0.8926474042753113
6649300190,407500.0,5,2.0,2740,8230,1.5,0,0,3,7,2210,530,98155,47.7352,-122.297,2130,8232,5490,6102,58,-610,2,442,377225.0,0.0034787466355187,0.0018071036519961,0.0033930572827905,0.0038881960237693,0.0028032844491414,0.0018950603428926,1.080257140963616
9346900170,615000.0,4,2.25,2330,7020,1.0,0,0,4,8,1450,880,98006,47.562,-122.139,2330,8500,4690,6170,47,0,1480,490,760184.5,0.0016483077256112,0.0010667751069396,0.0012864634764146,0.0030720893698725,0.0017083551765728,0.0014227791630811,0.8090141274914182
9144100158,445000.0,3,1.0,1260,8910,1.0,0,0,4,7,1260,0,98117,47.7,-122.375,1560,8910,7650,7350,71,300,0,548,545000.0,0.0013579078734947,0.0035071242643797,0.0017226104931587,0.0,0.0018483850328206,0.0035026820480665,0.8165137614678899
16000200,250000.0,3,2.25,1640,4420,2.0,0,0,4,7,1640,0,98002,47.311,-122.21,1230,6632,2780,5402,102,-410,2212,197,235000.0,0.0051153926531732,0.002987855247201,0.0054727779353611,0.0,0.0042230744668797,0.004436788145373,1.0638297872340423
4017050820,569999.0,3,2.5,3080,13880,2.0,0,0,3,9,3080,0,98038,47.3726,-122.025,2780,15318,10800,12538,30,-300,1438,586,342750.0,0.0024433546307123,0.0009317732531131,0.0025542953627928,0.0,0.0022376784810187,0.0013062199879798,1.663016776075857
1377300135,570000.0,2,1.0,1100,6240,1.0,0,0,4,7,1100,0,98199,47.6446,-122.403,1250,6240,5140,4990,79,150,0,316,689900.0,0.0016099053082968,0.0036301188165812,0.0021872700880873,0.0,0.0019854506178722,0.0037384431780601,0.826206696622699
6135300010,248000.0,2,1.0,700,8301,1.0,0,0,3,6,700,0,98155,47.7712,-122.323,1250,8304,7601,7054,67,550,3,442,377225.0,0.0008887308922858,0.0018226934890911,0.0010747240262232,0.0,0.0016451199818905,0.0019116352146963,0.6574325667704951
2924079044,865000.0,3,3.75,3830,219106,2.0,0,0,3,9,3830,0,98027,47.5432,-121.952,2440,219106,215276,216666,43,-1390,0,411,571000.0,0.0037037789182451,0.0161894577226955,0.0044070148630315,0.0,0.0024976993527478,0.0187072252565726,1.5148861646234677
8087800480,480000.0,5,2.5,2040,9597,1.0,0,0,4,7,1240,800,98052,47.6544,-122.134,1800,8553,7557,6753,57,-240,-1044,571,615000.0,0.0015093021844929,0.0015118266526989,0.001031950519637,0.0053329778014799,0.001349943639853,0.0014904700879574,0.7804878048780488
7227800040,190000.0,5,2.0,1750,10284,1.0,0,0,4,5,1750,0,98056,47.5094,-122.182,1560,9010,8534,7450,77,-190,-1274,404,380000.0,0.0021481855197565,0.0026576527685175,0.0024230306991066,0.0,0.0020225199821084,0.0028474173040172,0.5
925069100,820000.0,3,2.5,3030,46538,2.0,0,0,3,10,3030,0,98053,47.664,-122.041,3370,51450,43508,48080,23,340,4912,400,635000.0,0.0028910393047766,0.003301579860377,0.0029786891015369,0.0,0.0034053647125397,0.0044283541361257,1.2913385826771653
104530110,268000.0,3,2.5,1850,6676,2.0,0,0,3,7,1850,0,98023,47.3103,-122.36,1700,6663,4826,4963,34,-150,-13,492,269000.0,0.0018813718760328,0.0012926248164215,0.0021948531287334,0.0,0.0017529532105853,0.0013888790455818,0.9962825278810408
6204410200,371025.0,3,2.0,1530,8925,1.0,0,0,3,7,1530,0,98011,47.736,-122.199,2040,8856,7395,6816,43,510,-69,194,470000.0,0.0034955129493904,0.0040586980969821,0.0040249494250635,0.0,0.0046731648092363,0.0047966020818856,0.7894148936170213
8850000517,480000.0,3,2.5,1590,1431,2.0,0,0,3,8,1060,530,98144,47.5893,-122.309,1620,1548,-159,-72,10,30,117,340,452500.0,0.0024462140606538,0.0010276060513142,0.0021065140967525,0.0036107723646471,0.0027054695576223,0.0011602736686834,1.0607734806629834
3834000400,415000.0,3,1.0,1630,8146,1.0,0,0,3,7,1630,0,98125,47.7293,-122.29,1480,8146,6516,6666,68,-150,0,402,425000.0,0.0023145255648578,0.0026339418948408,0.0028480918658146,0.0,0.0022183650649471,0.0027675214070125,0.976470588235294
4031000260,200000.0,2,1.0,1730,9610,1.0,0,0,3,7,1380,350,98001,47.2956,-122.285,1310,9812,7880,8502,58,-420,202,358,260000.0,0.0025323644965425,0.0017935900711631,0.0022324100646104,0.0053854439144483,0.0019970851703467,0.0024470530493268,0.7692307692307693
7227502155,208000.0,2,1.0,820,5700,1.0,0,0,5,5,820,0,98056,47.4915,-122.184,1000,5700,4880,4700,78,180,0,404,380000.0,0.0010065783578287,0.0014730280805668,0.0011353629561528,0.0,0.0012964871680182,0.0018013627783461,0.5473684210526316
9222400605,850000.0,5,4.0,2980,4500,1.5,0,0,3,7,2070,910,98115,47.6736,-122.323,1560,4225,1520,2665,99,-1420,-275,576,570000.0,0.0028216837877222,0.0014333287148296,0.0025518223339928,0.0037154685981659,0.0016010328714627,0.0013877752927384,1.4912280701754386
2623089002,446250.0,3,2.5,2380,214315,1.5,0,0,3,9,2380,0,98045,47.4525,-121.748,2400,68824,211935,66424,20,20,-145491,218,404750.0,0.005273478612499,0.0194322868922395,0.0056136709398181,0.0,0.005744719047334,0.0097293566769661,1.102532427424336
2558630350,462000.0,4,2.5,2060,6958,1.0,0,0,3,7,1220,840,98034,47.7251,-122.168,1760,7350,4898,5590,46,-300,392,543,446000.0,0.0019182990833137,0.0013115050736472,0.0013518305114794,0.004901159941186,0.0016941892197584,0.0015941332426448,1.0358744394618835
3303980210,1115000.0,4,3.75,4040,14212,2.0,0,0,3,11,4040,0,98059,47.5189,-122.147,3940,14212,10172,10272,18,-100,0,465,435000.0,0.0036045360052105,0.0021199268198636,0.0038180202997712,0.0,0.0036015184879472,0.0024264414508316,2.5632183908045976
792500190,410000.0,3,2.0,1400,45738,2.0,0,0,4,8,1400,0,98070,47.3624,-122.455,2390,56628,44338,54238,39,990,10890,116,466250.0,0.0063492639389019,0.0040815321245972,0.0071311780196718,0.0,0.0116205572032868,0.0060626051665755,0.8793565683646113
2822059091,213500.0,2,1.5,2060,7713,1.5,0,0,4,7,2060,0,98030,47.3722,-122.185,1780,7713,5653,5933,90,-280,0,253,283000.0,0.0041328946312494,0.0025830248416461,0.0044989953699659,0.0,0.0036553310333497,0.0035547726729097,0.7544169611307421
1450000050,201000.0,3,1.0,900,7576,1.0,0,0,4,6,900,0,98002,47.2881,-122.22,1220,7452,6676,6232,61,320,-124,197,235000.0,0.0028072276755219,0.0051212650119446,0.0030033537450152,0.0,0.0041887405281246,0.0049853656904885,0.8553191489361702
1438000440,515805.0,5,2.75,2710,4136,2.0,0,0,3,8,2710,0,98059,47.4786,-122.123,2590,4136,1426,1546,6,-120,0,465,435000.0,0.0024178942015149,0.0006169446472668,0.0025610977753416,0.0,0.0023674956557825,0.0007061470476104,1.185758620689655
2472950350,312500.0,4,2.5,2500,11983,1.0,0,0,3,7,1320,1180,98058,47.4292,-122.148,1460,9005,9483,7545,36,-1040,-2978,451,335000.0,0.0026976515324818,0.0013574208030543,0.0016178810171078,0.0106450157870996,0.0016353431252303,0.0014472570821979,0.9328358208955224
1698900195,710000.0,3,2.0,1880,3000,1.0,0,0,4,8,1040,840,98109,47.6418,-122.351,1790,3000,1120,1210,89,-90,0,109,736000.0,0.0083939438588031,0.0076007479135946,0.0058272772607314,0.0184615384615384,0.0085161044769018,0.0076331216414264,0.9646739130434784
7787100390,440000.0,3,2.5,2040,7605,2.0,0,0,3,8,2040,0,98045,47.4876,-121.779,2150,7545,5565,5395,24,110,-60,218,404750.0,0.0045201245249991,0.0006895576222638,0.0048117179484155,0.0,0.0051463108132367,0.0010666046165248,1.087090796788141
8956000460,625000.0,3,2.5,2010,3200,2.0,0,0,3,9,2010,0,98027,47.5463,-122.015,2250,3200,1190,950,11,240,0,411,571000.0,0.0019437586490007,0.0002364438432202,0.0023128198106249,0.0,0.0023032063703617,0.0002732153424417,1.094570928196147
1775800420,474000.0,4,2.25,1960,14834,1.0,0,0,4,8,1330,630,98072,47.7434,-122.095,1540,15000,12874,13460,44,-420,166,272,517500.0,0.0030411313008439,0.001770907760346,0.0023479524266,0.0080721625707915,0.0024027959807776,0.0022988886252829,0.9159420289855073
1473120190,386000.0,3,2.0,2120,7560,1.0,0,0,3,9,2120,0,98058,47.435,-122.16,2660,7700,5440,5040,29,540,140,451,335000.0,0.0022876084995446,0.0008563883227147,0.0025984149668702,0.0,0.0029794607624059,0.0012375213251442,1.1522388059701492
4140100200,499000.0,3,2.25,3010,9600,2.0,0,0,3,8,2410,600,98028,47.7671,-122.263,2620,9660,6590,7040,42,-390,60,282,442500.0,0.0050252850304939,0.0028604212745024,0.0047961058008999,0.0062189054726368,0.0044430274992877,0.0033880459497594,1.127683615819209
5700001640,1039000.0,4,1.0,3410,5000,2.0,0,0,5,8,2190,1220,98144,47.5807,-122.291,2550,5000,1590,2450,110,-860,0,340,452500.0,0.0052462829854273,0.0035905173001895,0.0043521376149888,0.0083115892167349,0.0042586094888499,0.0037476539686156,2.2961325966850827
6083000123,158000.0,3,1.0,1140,10477,1.0,0,0,3,6,1140,0,98168,47.4874,-122.306,1190,9750,9337,8560,78,50,-727,264,237000.0,0.0029263033601149,0.0034961919638641,0.0034827238566584,0.0,0.0030525970161505,0.0037795810363494,0.6666666666666666
5511600245,350000.0,2,1.0,1350,3880,1.0,0,0,3,6,950,400,98103,47.6842,-122.344,1670,3920,2530,2250,93,320,40,599,550000.0,0.0013650013650013,0.0018616532536468,0.001128766068579,0.0027140172204392,0.0018296557617722,0.001885180938897,0.6363636363636364
1890000169,545000.0,3,2.5,1280,1845,3.0,0,0,3,8,1280,0,98105,47.662,-122.324,1450,1889,565,439,11,170,44,229,675000.0,0.0025990797633212,0.0015732293495528,0.0033006534262329,0.0,0.0031212665884556,0.0016701516752355,0.8074074074074075
6751500185,795000.0,5,3.0,2750,10000,1.0,0,0,4,7,1730,1020,98008,47.5878,-122.13,2520,10000,7250,7480,63,-230,0,283,545000.0,0.0045547522628837,0.0034682108991302,0.0035684524055082,0.008574238616017,0.0044057484527431,0.0037215062871127,1.4587155963302751
2523039282,250000.0,2,1.0,1420,21158,1.0,0,0,3,7,1420,0,98166,47.4594,-122.359,1220,8625,19738,7405,67,-200,-12533,250,392500.0,0.002735461599513,0.0061947568547687,0.0033141950240395,0.0,0.0025818466552388,0.0027109368148991,0.6369426751592356
1760650900,337500.0,4,2.5,2330,4907,2.0,0,0,3,7,2330,0,98042,47.359,-122.081,2300,3836,2577,1536,7,-30,-1071,546,292000.0,0.0021518723136229,0.0004730233081825,0.0023098855169186,0.0,0.0021523750522886,0.0004769447684032,1.1558219178082192
6381500720,395000.0,4,2.0,2240,7085,1.5,0,0,3,7,2240,0,98125,47.7309,-122.305,1440,7085,4845,5645,76,-800,0,402,425000.0,0.0031806977087616,0.0022908762981767,0.0039139421959661,0.0,0.0021584092523809,0.0024070573494578,0.9294117647058824
9161100460,525000.0,2,1.0,1000,4950,1.0,0,0,3,7,800,200,98116,47.5671,-122.394,1060,5500,3950,4440,72,60,550,329,565500.0,0.0016385599024729,0.0030215924830104,0.0017124680517679,0.0013973310976035,0.0019012463925643,0.0033929610247482,0.9283819628647216
8658300510,410500.0,4,2.5,1980,5000,2.0,0,0,3,8,1980,0,98014,47.6492,-121.908,1400,8500,3020,7100,12,-580,3500,123,415000.0,0.0075982009916036,0.0004168690565936,0.0081174821046417,0.0,0.0059124617801577,0.0008810397346847,0.989156626506024
7169500020,510000.0,2,2.25,1470,1101,2.0,0,0,3,8,1340,130,98115,47.6768,-122.301,1470,1582,-369,112,15,0,481,576,570000.0,0.0013919044187757,0.0003506877588949,0.0016519043128262,0.0005307812283094,0.0015086655904167,0.0005196356244052,0.8947368421052632
8691370500,751000.0,3,2.5,2840,6854,2.0,0,0,3,9,2840,0,98075,47.6006,-121.978,2840,7398,4014,4558,18,0,544,358,739999.5,0.0026270585177284,0.0010066891808232,0.0027975417094752,0.0,0.0026596317533809,0.0013725274839445,1.0148655505848314
7405700015,406000.0,3,1.0,1090,11292,1.0,0,0,4,7,1090,0,98133,47.7429,-122.358,1570,8198,10202,6628,68,480,-3094,484,375000.0,0.0013960076741999,0.0032875812578754,0.0016491314070268,0.0,0.0020922704599396,0.0025192191096812,1.0826666666666669
1152600220,831500.0,5,2.5,4470,35124,2.5,0,0,3,11,4470,0,98072,47.7377,-122.084,4050,34118,30654,30068,36,-420,-1006,272,517500.0,0.006935641283047,0.0041931619370631,0.0078912386066932,0.0,0.006319041378019,0.005228898807827,1.6067632850241549
3396800280,637000.0,4,2.5,2120,15000,2.0,0,0,4,8,2120,0,98052,47.7159,-122.1,2170,15000,12880,12830,37,50,0,571,615000.0,0.0015684905054534,0.0023629675722083,0.0017643025013149,0.0,0.0016274320547117,0.0026139426305812,1.0357723577235771
3293700521,389000.0,3,1.75,1820,8028,1.0,0,0,3,7,1220,600,98133,47.7466,-122.355,1940,11100,6208,9160,40,120,3072,484,375000.0,0.0023309485936183,0.0023372920951313,0.0018458168041951,0.0050065084609992,0.0025853533071866,0.0034109944032035,1.0373333333333334
2461900760,553000.0,3,1.0,1380,6250,1.0,0,0,4,7,1380,0,98136,47.5514,-122.385,2270,6250,4870,3980,102,890,0,263,489950.0,0.0030386034754577,0.0039724155464454,0.0038806557745845,0.0,0.0051616717449633,0.0041304863598122,1.128686600673538
8964800050,1770000.0,3,2.5,2580,14603,1.0,0,2,4,9,2580,0,98004,47.6199,-122.212,2410,14347,12023,11937,69,-170,-256,315,1150000.0,0.0028138905854637,0.0035430604491774,0.0033866712172326,0.0,0.0028626407564023,0.0035586791389519,1.5391304347826087
8563000770,490000.0,3,1.75,1510,8433,1.0,0,0,4,7,1220,290,98008,47.6226,-122.103,1950,8199,6923,6249,53,440,-234,283,545000.0,0.0025009730607107,0.0029247422512365,0.0025164808871213,0.0024377737241617,0.0034092101122416,0.0030512630048037,0.8990825688073395
1726059134,1075000.0,3,2.5,2830,56628,2.0,0,0,3,11,2830,0,98011,47.7409,-122.198,2830,16430,53798,13600,19,0,-40198,194,470000.0,0.006465556631879,0.0257519278247515,0.0074448410934182,0.0,0.0064828707892837,0.0088988450999752,2.2872340425531914
7853302130,418500.0,3,2.5,2060,4399,2.0,0,0,3,7,2060,0,98065,47.5415,-121.884,2060,4399,2339,2339,13,0,0,305,500000.0,0.0026157069392419,0.0008366241691764,0.002740527884206,0.0,0.0026716641484718,0.0012740358786343,0.837
3438501860,385000.0,3,1.0,1020,5950,1.0,0,0,3,6,880,140,98106,47.5436,-122.357,1800,5950,4930,4150,70,780,0,330,315000.0,0.0020727031096642,0.0032577873436878,0.0022379272724498,0.0014157144301749,0.0040012270429598,0.0035363495125781,1.2222222222222223
7215730590,700000.0,4,3.5,3150,6175,2.0,0,0,3,9,3150,0,98075,47.5966,-122.017,3150,6986,3025,3836,19,0,811,358,739999.5,0.002913814905227,0.0009069602701463,0.003102907177763,0.0,0.0029499436701232,0.0012960904302292,0.945946585099044
2968801085,334000.0,4,1.5,1680,7620,1.0,0,0,4,7,1180,500,98166,47.4578,-122.351,1460,7620,5940,6160,55,-220,0,250,392500.0,0.003236320765621,0.0022310259586604,0.0027540493861737,0.0055158414967787,0.0030897509152858,0.0023950537425543,0.8509554140127389
5015001215,1125000.0,4,3.5,3170,4000,2.0,0,0,3,10,2340,830,98112,47.6265,-122.298,1770,4000,830,2230,21,-1400,0,268,917500.0,0.0047326712570094,0.0029885850992135,0.0043560655420323,0.0062580110080675,0.0028945169345593,0.0030450554009767,1.2261580381471389
8682220150,835000.0,2,2.0,2280,6815,1.0,0,0,3,8,2280,0,98053,47.7103,-122.027,2280,6750,4535,4470,18,0,-65,400,635000.0,0.0021754355164655,0.0004834816010243,0.0022413898189782,0.0,0.0023039262743592,0.0005809794056141,1.31496062992126
2420069220,209000.0,3,1.0,1320,3954,1.5,0,0,3,6,1320,0,98022,47.202,-121.994,1270,5184,2634,3914,108,-50,1230,233,280000.0,0.0030834349465304,0.0002286011356515,0.0032788188303559,0.0,0.0030255384028968,0.0004321151586897,0.7464285714285714
1257201095,826000.0,2,1.0,1060,6120,1.0,0,0,3,7,1060,0,98103,47.6739,-122.329,1730,4080,5060,2350,112,670,-2040,599,550000.0,0.0010717788495566,0.0029364221423502,0.0012594652975724,0.0,0.0018953918969257,0.0019621270996683,1.5018181818181815
808300490,414000.0,4,2.5,2120,6497,2.0,0,0,3,7,2120,0,98019,47.7241,-121.957,2230,6300,4377,4070,17,110,-197,190,401250.0,0.0051381981405539,0.0008583364390835,0.0054796503362747,0.0,0.0055790866809938,0.0008957596020097,1.0317757009345794
4154304740,709000.0,3,2.75,2780,7200,1.5,0,0,4,8,1870,910,98118,47.5632,-122.27,1700,7200,4420,5500,107,-1080,0,498,370000.0,0.003290692430342,0.002498228686466,0.0028151415474245,0.0050403784161026,0.0021166735354798,0.0026011259985433,1.916216216216216
4438400020,192000.0,2,1.0,700,10540,1.0,0,0,3,6,700,0,98166,47.438,-122.336,890,10540,9840,9650,67,190,0,250,392500.0,0.0013484669856754,0.003085959790588,0.001633758110442,0.0,0.0018834782976742,0.0033128433656854,0.489171974522293
1446403617,123000.0,2,1.0,1050,6600,1.5,0,0,3,6,1050,0,98168,47.4828,-122.324,1330,6600,5550,5270,56,280,0,264,237000.0,0.0026952794106322,0.0022024307494037,0.003207771973238,0.0,0.0034117260768741,0.0025584856246058,0.5189873417721519
4396000530,290000.0,3,1.75,1520,15090,1.0,0,0,4,7,1520,0,98038,47.398,-121.964,1580,18618,13570,17038,52,60,3528,586,342750.0,0.0012058113761956,0.0010130013248902,0.0012605613478718,0.0,0.0012717741007228,0.0015876226489234,0.8460977388767323
7899800851,300500.0,2,1.5,1190,801,3.0,0,0,3,8,1190,0,98106,47.5212,-122.358,1190,810,-389,-380,10,0,9,330,315000.0,0.0024181536279416,0.0004385693550073,0.0030262880161537,0.0,0.002645255656179,0.0004814190092753,0.953968253968254
8029500450,300000.0,3,2.5,2080,9827,2.0,0,0,3,8,2080,0,98023,47.3058,-122.394,2660,9861,7747,7201,31,580,34,492,269000.0,0.0021152721633234,0.0019027297889416,0.0024677267609543,0.0,0.0027428562000923,0.0020554909603005,1.1152416356877324
1139000135,440000.0,4,1.0,1480,7560,1.5,0,0,3,7,1480,0,98177,47.7079,-122.358,1480,7560,6080,6080,80,0,0,254,557000.0,0.0025055867813367,0.0024967337702397,0.0031685406729295,0.0,0.0026652260039618,0.0025429646662459,0.7899461400359067
5702450260,324000.0,3,2.0,1540,10931,1.0,0,3,3,7,1540,0,98045,47.495,-121.776,1570,10485,9391,8915,31,30,-446,218,404750.0,0.0034122508669111,0.000991131409463,0.0036323753139999,0.0,0.003758003710131,0.001482219934296,0.8004941321803583
6799300130,300000.0,4,2.5,1840,5550,2.0,0,0,3,8,1840,0,98031,47.3937,-122.183,2030,5500,3710,3470,16,190,-50,271,288400.0,0.0035138242247625,0.0016871439328328,0.0039733440440868,0.0,0.0039191685956827,0.0023908947771555,1.0402219140083218
9201000120,650000.0,3,2.25,1790,9927,1.0,0,2,4,7,1240,550,98075,47.5822,-122.077,2610,10700,8137,8090,51,820,773,358,739999.5,0.0016557868826528,0.0014580396116183,0.0012214618731511,0.0083485124468731,0.0024442390409592,0.0019851370746426,0.8783789718776837
1972200698,474800.0,2,3.25,1400,1243,3.0,0,0,3,8,1400,0,98103,47.6534,-122.353,1400,1335,-157,-65,20,0,92,599,550000.0,0.0014155569711125,0.0005964007717224,0.0016634447326428,0.0,0.0015338431535815,0.0006420195289356,0.8632727272727273
1972202023,504500.0,3,2.5,1820,1545,3.0,0,2,3,8,1640,180,98103,47.6523,-122.346,1440,1290,-275,-150,22,-380,-255,599,550000.0,0.0018402240624462,0.0007413026486815,0.0019486066868101,0.0012213077491976,0.0015776672436838,0.0006203784212186,0.9172727272727272
923049203,350000.0,4,2.5,2040,22653,2.0,0,0,3,7,2040,0,98168,47.4991,-122.299,2020,20502,20613,18482,9,-20,-2151,264,237000.0,0.0052365428549426,0.0075593429948853,0.0062322426908624,0.0,0.0051817193047261,0.0079475867084345,1.4767932489451476
7322910030,1095000.0,5,3.5,4410,57063,2.0,0,0,4,9,4410,0,98053,47.6554,-122.018,2900,50529,52653,47629,30,-1510,-6534,400,635000.0,0.0042077502752689,0.0040482627438371,0.0043353197814448,0.0,0.0029304325419481,0.0043490827238931,1.7244094488188977
5569620050,731688.0,4,3.0,2630,5772,2.0,0,0,3,9,2630,0,98052,47.6952,-122.133,3460,6158,3142,2698,14,830,386,571,615000.0,0.0019458160515767,0.0009092699217857,0.0021887337634236,0.0,0.002594891663273,0.0010731105812746,1.1897365853658537
2331300395,875000.0,4,2.0,2520,6000,1.0,0,0,3,8,1400,1120,98103,47.6767,-122.35,1580,3720,3480,2140,99,-940,-2280,599,550000.0,0.0025480025480025,0.0028788452375982,0.0016634447326428,0.0075992482172299,0.001731051559042,0.0017889982379329,1.5909090909090908
4077800507,518500.0,4,3.0,2120,5520,1.5,0,0,3,8,1420,700,98125,47.7085,-122.286,2020,8700,3400,6680,35,-100,3180,402,425000.0,0.0030103031886494,0.0017848464595533,0.0024811597849428,0.0053056429302307,0.00302776853459,0.0029557373239637,1.22
8078570410,279000.0,3,2.5,1920,7779,2.0,0,0,3,7,1920,0,98031,47.4024,-122.171,1960,7536,5859,5576,31,40,-243,271,288400.0,0.0036665991910565,0.0023647374150462,0.0041460981329601,0.0,0.003784024851004,0.0032759605528444,0.9674063800277392
9521100106,440000.0,4,1.0,1780,4000,1.5,0,0,3,7,1780,0,98103,47.6624,-122.354,1750,4000,2220,2250,98,-30,0,599,550000.0,0.0017997795775573,0.0019192301583988,0.0021149511600744,0.0,0.0019173039419769,0.0019236540192827,0.8
393000385,255000.0,3,1.5,1320,7980,1.0,0,0,3,7,1320,0,98178,47.5068,-122.259,2000,7700,6660,5700,64,680,-280,258,279500.0,0.0029459025174076,0.0037227407209054,0.0038476112746669,0.0,0.0046967099546767,0.0036699084191035,0.9123434704830052
2325069032,875000.0,5,4.25,4720,18741,2.0,0,0,3,11,3210,1510,98053,47.6347,-122.013,3880,37328,14021,33448,15,-840,18587,400,635000.0,0.0045035331744374,0.0013295566668813,0.0031556409293509,0.0489623865110246,0.0039207166423306,0.0032128591485578,1.3779527559055118
4154303125,650000.0,3,1.75,2330,7200,1.0,0,0,4,8,1320,1010,98118,47.565,-122.274,1820,7200,4870,5380,70,-510,0,498,370000.0,0.0027580263894593,0.002498228686466,0.0019871587393585,0.0055942661541358,0.002266085785043,0.0026011259985433,1.7567567567567568
5130000080,481000.0,4,2.5,2480,9869,1.0,0,0,4,8,1240,1240,98028,47.7612,-122.229,2230,10310,7389,8080,57,-250,441,282,442500.0,0.0041404341779485,0.0029405726622983,0.0024677058892597,0.0128524046434494,0.0037816608104624,0.0036160200561096,1.0870056497175142
1923300315,565000.0,2,1.75,1720,3000,1.0,0,0,5,7,860,860,98103,47.686,-122.351,1360,4500,1280,3140,95,-360,1500,599,550000.0,0.0017391128502239,0.0014394226187991,0.0010218303357663,0.0058351370239444,0.0014900190634791,0.002164110771693,1.0272727272727271
1924069115,873000.0,3,2.25,2720,54450,2.0,0,0,3,11,2720,0,98027,47.5473,-122.092,3170,60548,51730,57378,23,450,6098,411,571000.0,0.0026303599628268,0.0040232397697953,0.0031297860123879,0.0,0.0032449618640207,0.0051695757981751,1.5288966725043782
821069025,685000.0,3,2.5,3290,90796,2.0,0,0,4,10,3290,0,98042,47.3154,-122.079,2700,55023,87506,52323,28,-590,-35773,546,292000.0,0.0030384806488495,0.0087525217627352,0.0032615980045761,0.0,0.0025267011483388,0.00684122314699,2.345890410958904
9407150350,308950.0,3,2.5,1600,6250,2.0,0,0,3,7,1600,0,98038,47.3675,-122.02,1760,6110,4650,4350,25,160,-140,586,342750.0,0.0012692751328375,0.0004195664864522,0.0013269066819703,0.0,0.0014166597577672,0.0005210212904136,0.901385849744712
5379801920,500000.0,4,2.5,3630,7482,2.0,0,0,3,10,3630,0,98188,47.4565,-122.287,1600,15716,3852,14116,12,-2030,8234,135,265000.0,0.0148876047361448,0.0054675117121817,0.0180074708680791,0.0,0.0072321614218429,0.0119270142014645,1.8867924528301887
3500100025,300000.0,4,1.0,1370,8499,1.0,0,0,3,7,1370,0,98155,47.736,-122.301,1370,8187,7129,6817,71,0,-312,442,377225.0,0.0017393733177593,0.0018661693728208,0.0021033884513226,0.0,0.001803051500152,0.0018847010480153,0.7952813307707601
5710500230,545000.0,3,2.0,1900,9975,1.0,0,0,3,8,1500,400,98027,47.5307,-122.054,2140,9825,8075,7685,47,240,-150,411,571000.0,0.0018373837975628,0.0007370397925382,0.0017259849333021,0.002424095509363,0.0021906051700329,0.0008388564810905,0.9544658493870404
7657000085,218000.0,2,1.5,2010,7755,2.0,0,0,3,7,2010,0,98178,47.4947,-122.233,1360,8037,5745,6677,68,-650,282,258,279500.0,0.0044858061060524,0.0036177762268949,0.0058588626227883,0.0,0.0031937627691801,0.0038305264888746,0.7799642218246869
3655500030,719000.0,3,3.5,2540,10578,2.0,0,1,3,9,2010,530,98006,47.547,-122.192,3240,9831,8038,6591,6,700,-747,490,760184.5,0.0017968676493787,0.0016074568491748,0.0017833045431679,0.0018502356432187,0.0023755668549767,0.0016455696414412,0.945823020595658
9835800750,247000.0,3,2.25,1640,7630,1.0,0,0,4,8,1180,460,98032,47.3739,-122.29,1930,7630,5990,5700,52,290,0,123,250000.0,0.0076383519789852,0.0059670210644446,0.0066764739164874,0.0121161038824211,0.0093940588661906,0.0066759353965444,0.988
2944500330,330000.0,4,2.5,2510,8580,2.0,0,0,4,8,2510,0,98023,47.295,-122.37,2290,7809,6070,5519,29,-220,-771,492,269000.0,0.0025525640047797,0.0016612823434536,0.0029778818124978,0.0,0.0023613310895532,0.0016277587373478,1.2267657992565055
9413600670,725000.0,3,1.75,1610,8613,1.0,0,0,5,7,1610,0,98033,47.6527,-122.195,2010,8670,7003,6660,58,400,57,431,678000.0,0.001569952092083,0.0019017287781044,0.0018149781920788,0.0,0.0021128492771112,0.0020258822226381,1.0693215339233038
1118001201,2300000.0,4,2.5,3370,8402,1.0,0,0,5,10,2240,1130,98112,47.6349,-122.29,3190,8700,5032,5510,58,-180,298,268,917500.0,0.0050312625035084,0.006277523000898,0.0041699088949369,0.0085199426977305,0.0052166717634149,0.0066229954971243,2.5068119891008176
8902000175,489000.0,4,2.0,2120,11479,1.0,0,0,4,7,1060,1060,98125,47.7084,-122.303,1540,11000,9359,9460,80,-580,-479,402,425000.0,0.0030103031886494,0.0037116399473211,0.0018521333605911,0.0080342592943494,0.0023082987837963,0.0037371391452415,1.1505882352941177
8732190170,266000.0,4,2.25,1860,12693,1.0,0,0,3,8,1140,720,98023,47.3114,-122.395,1950,8740,10833,6790,42,90,-3953,492,269000.0,0.0018915414537411,0.0024576523059973,0.0013525040901384,0.0051265985018939,0.0020107404474361,0.0018218224310948,0.9888475836431226
7853240040,700000.0,4,2.75,3350,7857,2.0,0,2,3,9,3350,0,98065,47.5398,-121.859,3870,7886,4507,4016,16,520,29,305,500000.0,0.0042536981778934,0.0014942841775902,0.0044566836951894,0.0,0.0050190972109641,0.0022839388358515,1.4
203100440,1210000.0,3,3.75,5400,24740,2.0,0,0,3,11,5400,0,98053,47.6426,-121.955,1690,20000,19340,18310,23,-3710,-4740,400,635000.0,0.0051523472758394,0.0017551481745181,0.0053085548344222,0.0,0.0017077348261697,0.001721420461079,1.905511811023622
7504030090,660000.0,4,1.75,2780,9900,2.0,0,0,4,10,2780,0,98074,47.6348,-122.06,2600,12000,7120,9400,42,-180,2100,435,645000.0,0.0024099957608347,0.0015599318735207,0.0026125634227964,0.0,0.0023078268171251,0.0020876979268115,1.0232558139534884
4141010050,1288000.0,3,2.5,3240,12625,2.0,0,0,3,11,3240,0,98040,47.5327,-122.232,3470,12331,9385,8861,33,230,-294,282,993750.0,0.0036980939977879,0.0032667823991715,0.0046434237511124,0.0,0.0042449287170039,0.0034158254297413,1.2961006289308177
4047200135,289275.0,3,2.0,2860,24046,1.0,0,0,3,9,1700,1160,98019,47.7718,-121.904,1460,13648,21186,12188,35,-1400,-10398,190,401250.0,0.0069317201330114,0.0031767828250273,0.0043940592319184,0.0451186308829249,0.0036526755848659,0.0019405281028934,0.7209345794392523
7308900490,650000.0,3,2.5,2540,8073,1.0,0,0,4,8,1880,660,98177,47.7176,-122.36,2110,7702,5533,5592,83,-430,-371,254,557000.0,0.0043001286652671,0.0026661549903631,0.0040249030169645,0.0053403243033304,0.0037997478840266,0.0025907293464849,1.1669658886894076
6448600060,1550000.0,5,2.5,2450,20805,2.0,0,0,4,9,2450,0,98004,47.6275,-122.227,3020,20324,18355,17304,57,570,-481,315,1150000.0,0.0026721054009248,0.0050478239159855,0.0032160249931085,0.0,0.0035872095785622,0.0050412347403679,1.3478260869565215
7625703405,431000.0,2,1.0,1000,6500,1.0,0,0,4,7,1000,0,98136,47.5474,-122.388,1280,6500,5500,5220,102,280,0,263,489950.0,0.0022018865764186,0.0041313121683033,0.0028120694018728,0.0,0.002910546182182,0.0042957058142047,0.879681600163282
7613700270,980000.0,4,1.75,2120,4000,1.5,0,0,4,8,1920,200,98105,47.6601,-122.275,2300,4000,1880,1700,91,180,0,229,675000.0,0.0043047258580009,0.0034107953377838,0.0049509801393494,0.0019105846388995,0.0049509745885847,0.0035365837485135,1.451851851851852
6300500505,359950.0,3,1.0,1400,4980,1.0,0,0,3,6,950,450,98133,47.7041,-122.34,990,4980,3580,3990,77,-410,0,484,375000.0,0.0017930373797064,0.001449889715216,0.0014373163639224,0.0037548813457494,0.0013193297804715,0.0015303380295453,0.9598666666666666
6046400465,397500.0,3,1.0,1480,5100,1.5,0,0,3,7,1480,0,98103,47.6915,-122.348,1300,5100,3620,3800,82,-180,0,599,550000.0,0.0014964459408903,0.0024470184519585,0.0017584987173652,0.0,0.0014242829283257,0.0024526588745854,0.7227272727272728
5458800125,925000.0,4,2.5,2190,7350,2.5,0,0,5,8,2190,0,98040,47.5786,-122.236,1880,7350,5160,5470,62,-310,0,282,993750.0,0.0024996376096159,0.0019018495551612,0.0031386104984371,0.0,0.0022998461060424,0.0020360325122535,0.9308176100628932
2525049266,1762000.0,3,2.25,3060,16000,2.0,0,0,3,10,3060,0,98039,47.6189,-122.23,3510,13162,12940,9652,32,450,-2838,49,1905000.0,0.0162054812657222,0.0185602145560802,0.0187356497780499,0.0,0.0226890756302521,0.0153683404247369,0.9249343832020998
2523089097,524500.0,3,1.5,3430,264844,1.0,0,2,3,7,2230,1200,98045,47.4476,-121.723,1660,145926,261414,144266,32,-1770,-118918,218,404750.0,0.0076000132944838,0.0240138328613875,0.0052598681494934,0.0438756855575868,0.003973430674406,0.0206289390683911,1.2958616429894998
8558600085,311100.0,4,2.25,2130,8078,1.0,0,0,4,7,1380,750,98055,47.4482,-122.209,2300,8112,5948,5812,43,170,34,260,297225.0,0.0045808224834509,0.0030804619091237,0.0033444005525531,0.0143261002444987,0.0049511877468866,0.0041060465483546,1.0466818067120869
6699000610,305000.0,3,2.5,2460,5027,2.0,0,0,3,8,2460,0,98042,47.372,-122.102,2740,5000,2567,2260,18,280,-27,546,292000.0,0.0022719338590181,0.0004845910271517,0.0024387632496222,0.0,0.0025641337579439,0.0006216694061565,1.0445205479452055
9524100207,245000.0,2,1.5,690,1058,2.0,0,0,3,7,690,0,98103,47.6951,-122.343,690,1058,368,368,15,0,0,599,550000.0,0.000697667364334,0.0005076363768964,0.0008198406182311,0.0,0.0007559655542651,0.0005088064881002,0.4454545454545454
1324059139,613000.0,3,2.25,1960,10385,1.0,0,0,3,8,1960,0,98008,47.5736,-122.109,2800,12632,8425,9832,32,840,2247,283,545000.0,0.0032462961582735,0.0036017370187467,0.0040428709334081,0.0,0.0048952760586034,0.0047010067418807,1.1247706422018349
8832900780,647500.0,5,2.0,1760,21562,1.0,0,1,3,8,1560,200,98028,47.7597,-122.263,2150,12676,19802,10526,61,390,-8886,282,442500.0,0.002938372642415,0.0064246253667521,0.0031045332155202,0.0020729684908789,0.0036459958486521,0.0044458458032246,1.463276836158192
7335400500,194900.0,2,1.0,810,6697,1.0,0,0,4,6,810,0,98002,47.3057,-122.216,1140,6695,5887,5555,97,330,-2,197,235000.0,0.0025265049079697,0.0045270738892546,0.0027030183705137,0.0,0.0039140690180836,0.004478934956766,0.8293617021276596
8643000190,310000.0,3,1.5,1860,10379,1.0,0,0,3,7,1240,620,98198,47.3962,-122.309,2240,11328,8519,9088,57,380,949,275,266750.0,0.0038659713460854,0.0035762623561776,0.0030512486743062,0.0082965341897497,0.0047469695685343,0.0043351041641951,1.162136832239925
2021200530,1110000.0,4,2.75,3090,6600,1.0,0,2,3,9,1800,1290,98199,47.6339,-122.396,2380,5000,3510,2620,64,-710,-1600,316,689900.0,0.0045223703660339,0.0038395487483071,0.0035791692350519,0.0071523619427811,0.0037802979764287,0.0029955474183174,1.6089288302652558
1025049266,555000.0,2,2.25,1160,954,2.0,0,0,3,8,960,200,98105,47.6647,-122.284,1160,1327,-206,167,6,0,373,229,675000.0,0.0023554160355099,0.0008134746880614,0.0024754900696747,0.0019105846388995,0.0024970132707644,0.0011732616585693,0.8222222222222222
2473100790,255000.0,3,1.5,1240,8528,1.0,0,0,4,7,1240,0,98058,47.4478,-122.157,1570,8064,7288,6494,53,330,-464,451,335000.0,0.001338035160111,0.0009660422772634,0.0015198276221316,0.0,0.001758553908638,0.0012960223332419,0.7611940298507462
3914000095,430000.0,5,2.5,3860,42733,1.0,0,3,4,8,2300,1560,98001,47.3117,-122.254,2520,19353,38873,16833,65,-1340,-23380,358,260000.0,0.0056502467957538,0.0079755967233106,0.0037206834410174,0.024003692875827,0.0038417210910487,0.004826520348922,1.6538461538461535
104510340,276200.0,3,2.5,1480,7210,1.0,0,0,3,7,1180,300,98023,47.3124,-122.351,1690,7396,5730,5706,34,210,186,492,269000.0,0.0015050975008262,0.0013960193119231,0.0013999603740029,0.0021360827091224,0.0017426417211113,0.001541670331851,1.0267657992565056
1774200190,580000.0,3,2.75,2660,32757,1.0,0,0,4,8,2660,0,98077,47.7649,-122.098,2720,35191,30097,32471,45,60,2434,196,652475.0,0.0047530130707859,0.0030349591493775,0.0050741570890361,0.0,0.0049902762998568,0.0039348855879825,0.8889229472393578
1954430390,575000.0,4,2.5,2400,6137,2.0,0,0,3,8,2400,0,98074,47.6187,-122.04,2120,7468,3737,5348,30,-280,1331,435,645000.0,0.0020805718798573,0.0009670001927067,0.0022554504369465,0.0,0.0018817664816558,0.0012992440097857,0.8914728682170543
9275702405,1015000.0,3,1.75,3610,8502,1.5,0,2,3,10,2610,1000,98126,47.583,-122.379,2900,5016,4892,2116,90,-710,-3486,352,396587.5,0.0066379451422561,0.0047356776664505,0.0059377154128077,0.0095895665515918,0.0058336719545214,0.0028404216463233,2.559334320925395
1432900350,215000.0,5,1.5,1980,7958,1.5,0,0,3,7,1980,0,98058,47.4571,-122.17,1510,8438,5978,6928,58,-470,480,451,335000.0,0.0021365400137256,0.0009014733164238,0.0024268215256617,0.0,0.0016913480267793,0.0013561305118918,0.6417910447761194
2105200010,515000.0,4,2.5,2030,39049,1.0,0,0,4,7,1530,500,98166,47.4413,-122.345,2400,14605,37019,12205,67,370,-24444,250,392500.0,0.0039105542584587,0.0114329832886786,0.0035709284413947,0.0055158414967787,0.0050790426004698,0.0045905196732291,1.3121019108280254
6817810190,401000.0,3,2.0,1240,11172,1.0,0,0,3,7,1000,240,98074,47.6364,-122.037,1330,14102,9932,12772,36,90,2930,435,645000.0,0.0010749621379263,0.0017603594839367,0.0009397710153943,0.0026833631484794,0.0011805421795293,0.002453393013658,0.6217054263565891
721049096,569950.0,5,4.5,4850,40902,2.0,0,0,3,10,4850,0,98023,47.3181,-122.344,1640,13503,36052,11863,19,-3210,-27399,492,269000.0,0.0049322451885185,0.0079195536610654,0.0057540744185715,0.0,0.0016910842737411,0.0028146531220908,2.118773234200744
11520370,738000.0,3,2.5,2620,9112,2.0,0,0,3,9,2620,0,98052,47.6972,-122.116,2620,9067,6492,6447,25,0,-45,571,615000.0,0.0019384175114566,0.0014354240345308,0.0021804115818137,0.0,0.0019649179646749,0.0015800411887653,1.2
5113260430,280000.0,3,2.0,1280,7633,1.0,0,0,3,7,1280,0,98038,47.3883,-122.05,1450,6783,6353,5333,29,170,-850,586,342750.0,0.00101542010627,0.0005124081585743,0.0010615253455762,0.0,0.0011671344595241,0.0005784103785394,0.8169219547775346
6151800624,288349.0,3,1.0,1250,18616,1.0,0,0,4,6,1250,0,98010,47.3414,-122.047,1920,15654,17366,13734,48,670,-2962,99,359999.0,0.0059408105166604,0.003481398102249,0.0063553720689024,0.0,0.0097202393608942,0.0034036872191044,0.8009716693657483
1523069096,459900.0,3,1.75,2340,51836,1.5,0,0,3,8,1510,830,98027,47.4846,-122.035,2060,77536,49496,75476,42,-280,25700,411,571000.0,0.0022628832033142,0.0038300947053647,0.0017374914995242,0.0050299981819283,0.0021087133879756,0.0066200077473625,0.8054290718038529
2826049091,259950.0,2,1.0,790,8100,1.0,0,0,3,6,790,0,98125,47.7159,-122.305,1420,8100,7310,6680,73,630,0,402,425000.0,0.0011217639240722,0.0026190681743445,0.0013803635423273,0.0,0.0021284313460979,0.0027518933705869,0.6116470588235294
1241900028,880000.0,5,2.75,3020,9187,2.0,0,0,3,9,3020,0,98033,47.6806,-122.167,2250,9675,6167,7425,13,-770,488,431,678000.0,0.0029448790795595,0.0020284665371468,0.0034044932547068,0.0,0.002365129787811,0.00226071632111,1.297935103244838
7452500565,260000.0,3,2.0,2710,5000,2.0,0,0,3,6,2710,0,98126,47.5188,-122.373,850,5000,2290,4150,69,-1860,0,352,396587.5,0.0049830557716105,0.0027850374420433,0.0061652140876279,0.0,0.0017098693659804,0.0028313612901947,0.6555930280202982
7732650120,1050000.0,4,2.5,2750,9949,2.0,0,0,3,10,2750,0,98007,47.6595,-122.147,2750,9860,7199,7110,21,0,-89,139,560000.0,0.0090309021050211,0.0066897030750848,0.0104674177831912,0.0,0.0092811339858251,0.0073930667130545,1.875
6705600020,919990.0,5,3.25,3960,6352,2.0,0,0,3,10,3960,0,98075,47.5806,-122.055,2930,9875,2392,6945,6,-1030,3523,358,739999.5,0.0036630815951425,0.0009329573499546,0.0039007975949021,0.0,0.0027439158582416,0.0018320774403828,1.243230569750385
2902200240,499950.0,2,2.25,1060,1208,2.0,0,0,3,8,940,120,98102,47.6371,-122.327,1300,1169,148,-131,15,240,-39,104,710000.0,0.004738298414458,0.0032218832013997,0.0051576371437663,0.0028947051019177,0.0063955919612328,0.0034025683715406,0.7041549295774648
8670900140,995000.0,3,2.25,3200,3800,2.0,0,0,5,9,2650,550,98102,47.638,-122.317,2400,3900,600,1500,106,-800,100,104,710000.0,0.0143042971002507,0.0101350630507606,0.014540147267001,0.0132673983837896,0.0118072466976606,0.0113515967912819,1.4014084507042253
4030100290,1680000.0,5,3.5,5170,7197,3.0,1,4,3,11,3520,1650,98155,47.7561,-122.271,3020,12880,2027,9860,22,-2150,5683,442,377225.0,0.0065639124473109,0.0015802825010226,0.0054043265318655,0.0121047612060743,0.0039746098762474,0.0029650604004442,4.453575452316257
5317100325,883000.0,4,2.5,2800,6874,2.0,0,0,3,9,2170,630,98112,47.6215,-122.29,1430,6240,4074,4810,30,-1370,-634,268,917500.0,0.0041802774509862,0.0051358834929984,0.0040395992419701,0.0047500565482922,0.0023385080318756,0.0047502864255236,0.9623978201634876
103000116,645000.0,3,1.75,2070,5500,1.0,0,0,4,7,1130,940,98115,47.6733,-122.301,1800,4400,3430,2600,74,-270,-1100,576,570000.0,0.0019600286713372,0.001751846207014,0.0013930237861893,0.0038379565739296,0.0018473456209185,0.0014452571095974,1.131578947368421
3422059208,390000.0,3,2.5,1930,64904,1.0,0,0,4,8,1930,0,98042,47.346,-122.157,2350,57500,62974,55150,32,420,-7404,546,292000.0,0.0017824521739451,0.0062565935998124,0.0019133386470613,0.0,0.0021991658142949,0.0071491981707999,1.3356164383561644
5100401441,495000.0,4,2.0,1720,5413,2.0,0,0,3,7,1470,250,98115,47.6929,-122.321,1510,5413,3693,3903,82,-210,0,576,570000.0,0.001628622857343,0.001724135185194,0.0018121636864586,0.0010207331313642,0.001549717715326,0.0017779947123297,0.868421052631579
715010530,1881580.0,5,3.5,4410,13000,2.0,0,3,3,10,2920,1490,98006,47.5382,-122.111,5790,12969,8590,7179,6,1380,-31,490,760184.5,0.0031197583991182,0.0019755094572956,0.0025906712766419,0.0052016058648978,0.004245225953801,0.002170826231294,2.475162279683419
1421069159,520000.0,3,2.5,2280,58712,2.5,0,3,3,9,2280,0,98010,47.3053,-122.0,2240,24332,56432,22092,33,-40,-34380,99,359999.0,0.0108360383823885,0.0109797940147854,0.0115921986536779,0.0,0.0113402792543766,0.0052905658244059,1.444448456801269
3760500435,570000.0,3,2.75,2730,11936,2.0,0,2,3,8,1530,1200,98034,47.6987,-122.231,2810,12333,9206,9523,42,80,397,543,446000.0,0.0025422118919643,0.0022498023223705,0.0016953284283308,0.0070016570588372,0.0027049271065462,0.0026748905144951,1.2780269058295963
3574800520,441000.0,3,2.75,1910,7280,1.0,0,0,3,7,1160,750,98034,47.7319,-122.224,1710,8152,5370,6442,41,-200,872,543,446000.0,0.0017786171112278,0.0013721984673975,0.0012853470437017,0.0043760356617732,0.0016460588441971,0.0017680781216382,0.9887892376681614
6448000100,1728000.0,4,3.0,3700,20570,1.0,0,0,4,10,1850,1850,98004,47.6212,-122.224,3080,17595,16870,14515,44,-620,-2975,315,1150000.0,0.0040354244830294,0.0049908069190974,0.0024284270356125,0.0119300960856387,0.003658478643037,0.0043643242106265,1.5026086956521738
1543000060,462000.0,4,2.5,3070,6432,2.0,0,0,3,9,3070,0,98055,47.4487,-122.205,2910,5106,3362,2196,14,-160,-1326,260,297225.0,0.0066024061146452,0.0024527768011244,0.0074400794901,0.0,0.006264328844974,0.0025845011927883,1.5543779964673228
1042500013,219950.0,3,1.5,1650,9936,1.0,0,0,3,7,1090,560,98003,47.3285,-122.328,1560,9890,8286,8330,53,-90,-46,276,269500.0,0.0030952376485948,0.0033881913891652,0.0023742414407506,0.0075693064622953,0.0030058093045212,0.0036670999950314,0.8161410018552876
8138870530,419190.0,2,2.5,1590,1426,2.0,0,0,3,8,1590,0,98029,47.5441,-122.013,1590,1426,-164,-164,6,0,0,320,574500.0,0.0021779628513506,0.00051278473757,0.0022904062229904,0.0,0.0022463020781826,0.0006319879877963,0.7296605744125326
40000669,499950.0,4,2.5,2910,20067,2.0,0,0,3,9,2910,0,98168,47.4714,-122.273,1730,21420,17157,19690,19,-1180,1353,264,237000.0,0.0074697743666093,0.0066963905830735,0.0088901108972596,0.0,0.0044378091075129,0.008303448799857,2.109493670886076
2787320430,264000.0,4,1.75,1820,8118,1.0,0,0,4,7,1080,740,98031,47.4104,-122.172,1810,8050,6298,6240,40,-10,-68,271,288400.0,0.003475630483189,0.002467789990403,0.0023321801997901,0.0122192866578599,0.0034944311124067,0.0034994005374731,0.9153952843273232
1773100922,315000.0,3,3.25,1480,983,2.0,0,0,3,8,1180,300,98106,47.5555,-122.363,1330,1062,-497,-268,7,-150,79,330,315000.0,0.0030074515708854,0.0005382193208143,0.0030008570244213,0.0030336737789463,0.0029564622039647,0.000631193812161,1.0
2493200195,615000.0,3,1.75,2360,7291,1.0,0,0,4,8,1360,1000,98136,47.5274,-122.384,1860,5499,4931,3639,72,-500,-1792,263,489950.0,0.005196452320348,0.0046340610798614,0.003824414386547,0.0101475453087898,0.0042293874209832,0.0036341671188172,1.2552301255230125
1888120140,989000.0,5,4.5,4030,13474,2.0,0,0,3,11,4030,0,98075,47.5812,-121.995,3860,12438,9444,8578,20,-170,-1036,358,739999.5,0.0037278330374809,0.0019790093408829,0.0039697510877413,0.0,0.0036148516084684,0.00230758270415,1.3364873895185063
7230000350,300000.0,3,1.75,1830,51836,1.0,0,0,4,7,1430,400,98059,47.4774,-122.098,1320,51400,50006,50080,54,-510,-436,465,435000.0,0.0016327477449344,0.0077320944718865,0.0013514279773942,0.006382639221318,0.001206600102561,0.008775618531716,0.6896551724137931
461002615,580000.0,5,2.5,2720,5000,1.5,0,0,4,7,1530,1190,98117,47.6827,-122.376,1210,5000,2280,3790,81,-1510,0,548,545000.0,0.0029313566792901,0.0019680832011109,0.0020917413131213,0.0060575209977093,0.0014336832626365,0.001965590374897,1.0642201834862386
7525950180,1060000.0,4,2.5,4570,16015,2.0,0,2,3,11,4570,0,98074,47.6246,-122.067,4490,17668,11445,13178,30,-80,1653,435,645000.0,0.0039617556212284,0.0025234655509529,0.0042947535403523,0.0,0.0039854393880353,0.0030737872475755,1.6434108527131783
7550801225,500000.0,4,1.0,1440,7100,1.5,0,0,3,7,1440,0,98107,47.6725,-122.396,1490,5000,5660,3510,114,50,-2100,264,529975.0,0.0034491844116026,0.0084115449046178,0.0041378121318352,0.0,0.0037110834371108,0.0054975140241582,0.9434407283362424
3760500602,608095.0,3,2.5,2680,17707,2.0,0,1,3,9,2680,0,98034,47.7031,-122.224,2840,21743,15027,18903,37,160,4036,543,446000.0,0.0024956512346023,0.0033375711898638,0.0029695948940696,0.0,0.002733805331883,0.0047158148428336,1.3634417040358744
8643000185,237100.0,3,1.75,1360,9603,1.0,0,0,3,7,1360,0,98198,47.3959,-122.309,2240,10605,8243,8365,57,880,1002,275,266750.0,0.0028267317369227,0.0033088782547812,0.0033465308040778,0.0,0.0047469695685343,0.0040584198147324,0.8888472352389878
7338000730,167000.0,3,1.5,1280,5547,2.0,0,0,4,6,1280,0,98002,47.3344,-122.215,1150,4500,4267,3350,35,-130,-1047,197,235000.0,0.0039925015829644,0.0037496907367023,0.004271436437355,0.0,0.0039484029568388,0.0030104865280727,0.7106382978723405
9285800180,900000.0,4,3.5,3370,5000,2.0,0,2,3,8,2470,900,98126,47.5714,-122.38,1820,5000,1630,3180,12,-1550,0,352,396587.5,0.0061966413100839,0.0027850374420433,0.0056192172680594,0.0086306098964326,0.0036611320542169,0.0028313612901947,2.2693604816087243
9826701201,450000.0,2,1.5,1530,1012,2.0,0,0,3,8,1200,330,98122,47.602,-122.306,1530,1425,-518,-105,15,0,413,289,574000.0,0.0029595871279238,0.0009993077917371,0.0027766594010745,0.0038919683924991,0.0030927960088781,0.0013859508352177,0.7839721254355401
6431500280,393000.0,2,1.0,830,5000,1.0,0,0,4,7,830,0,98103,47.6914,-122.352,1110,5000,4170,3890,99,280,0,599,550000.0,0.0008392230614452,0.0023990376979985,0.0009861850914954,0.0,0.0012161185003396,0.0024045675241033,0.7145454545454546
3343901183,340000.0,3,1.0,1600,7324,1.0,0,0,4,7,1600,0,98056,47.5054,-122.19,1430,7249,5724,5819,62,-170,-75,404,380000.0,0.0019640553323488,0.0018927118705389,0.0022153423534689,0.0,0.0018539766502661,0.0022908910140755,0.8947368421052632
2025049111,1440000.0,3,3.5,3870,3819,2.0,0,0,3,11,2760,1110,98102,47.6452,-122.317,2530,5500,-51,2970,18,-1340,1681,104,710000.0,0.0172992593056157,0.0101857383660144,0.0151437005497821,0.0267760221927391,0.0124468058937839,0.0160086621415515,2.028169014084507
1523300140,325000.0,1,1.0,730,1942,1.0,0,0,3,7,730,0,98144,47.5943,-122.299,1020,2044,1212,1024,11,290,102,340,452500.0,0.0011231045687278,0.0013945569193936,0.0014507125383296,0.0,0.0017034437955399,0.00153204094237,0.7182320441988951
1068000235,1155000.0,4,2.25,2980,8051,1.5,0,2,4,10,2020,960,98199,47.6426,-122.409,2760,5499,5071,2739,85,-220,-2552,316,689900.0,0.0043613798352042,0.0046836677231243,0.0040166232526694,0.0053226879574184,0.0043838749642618,0.0032945030506654,1.674155674735469
624069108,3200000.0,4,3.25,7000,28206,1.0,1,4,4,12,3500,3500,98075,47.5928,-122.086,4913,14663,21206,9750,29,-2087,-13543,358,739999.5,0.0064751442338378,0.0041427888874087,0.0034476746419589,0.0531268973891924,0.0046009756353382,0.002720379899578,4.3243272461670585
3300760020,595000.0,3,2.0,1530,6773,1.0,0,0,4,8,1530,0,98033,47.6653,-122.194,2240,7201,5243,4961,36,710,428,431,678000.0,0.0014919420502404,0.001495461397202,0.0017247929402984,0.0,0.0023546180998652,0.0016826272070608,0.8775811209439528
7132300042,247300.0,2,2.0,1140,1118,2.0,0,0,3,7,1040,100,98144,47.596,-122.311,1140,1118,-22,-22,11,0,0,340,452500.0,0.0017538893265064,0.0008028396683223,0.0020667685477572,0.0006812778046504,0.0019038489479564,0.0008379754273824,0.5465193370165746
4206901505,465000.0,2,1.0,1120,4000,1.0,0,0,3,7,1120,0,98105,47.6567,-122.327,1620,4000,2880,2380,94,500,0,229,675000.0,0.0022741947929061,0.0034107953377838,0.0028880717479538,0.0,0.0034872081884814,0.0035365837485135,0.6888888888888889
2064800610,390000.0,3,2.5,1610,10292,1.0,0,0,4,7,1190,420,98056,47.5349,-122.174,1940,8700,8682,6760,51,330,-1592,404,380000.0,0.001976330678176,0.0026597201763498,0.0016476608753925,0.0045452085926086,0.0025151851059554,0.0027494484511598,1.0263157894736843
9414610240,485000.0,3,1.75,2030,10089,1.0,0,0,4,8,1330,700,98027,47.5217,-122.05,2030,9827,8059,7797,44,0,-262,411,571000.0,0.0019630995310803,0.0007454631044529,0.0015303733075279,0.0042421671413853,0.0020780039697041,0.0008390272406795,0.8493870402802102
3024059014,1900000.0,4,2.25,3020,11489,1.5,1,3,5,10,2110,910,98040,47.5395,-122.21,3890,11489,8469,7599,104,870,0,282,993750.0,0.00344698884979,0.0029728366720065,0.003023958060138,0.0051018691903165,0.004758724123673,0.0031825819773172,1.9119496855345912
7579200765,439000.0,2,2.5,1350,944,2.0,0,0,3,9,870,480,98116,47.5591,-122.385,1440,1350,-406,-90,16,90,406,329,565500.0,0.0022120558683384,0.0005762390513054,0.0018623090062976,0.0033535946342485,0.0025828252880119,0.0008328177060745,0.7763041556145004
1829300520,746500.0,4,2.5,3460,9699,2.0,0,0,3,10,3460,0,98074,47.637,-122.04,3140,10631,6239,7491,33,-320,932,435,645000.0,0.0029994911267943,0.0015282605294219,0.0032516077132645,0.0,0.002787144694528,0.0018495263883278,1.1573643410852714
2517000150,300000.0,3,2.5,1870,3439,2.0,0,0,3,7,1870,0,98042,47.3992,-122.163,2190,4029,1569,1839,15,320,590,546,292000.0,0.0017270391529935,0.0003315115461258,0.0018538566165827,0.0,0.0020494353758748,0.0005009412074809,1.0273972602739727
2221000100,310000.0,3,1.75,1840,10723,1.0,0,0,4,7,1220,620,98058,47.429,-122.154,1590,9820,8883,8230,46,-250,-903,451,335000.0,0.0019854715279066,0.0012146894159352,0.0014953142733875,0.0055931438881371,0.0017809558692576,0.0015782414821969,0.9253731343283582
7203140360,359782.0,3,2.5,1850,3400,2.0,0,0,3,7,1850,0,98053,47.6871,-122.014,1850,3400,1550,1550,10,0,0,400,635000.0,0.0017651560111672,0.0002412087224479,0.0018186715636446,0.0,0.0018694138629669,0.0002926414783834,0.5665858267716536
3288301010,585000.0,4,2.75,2890,6825,1.0,0,0,3,8,1560,1330,98034,47.734,-122.182,1900,10120,3935,8220,47,-990,3295,543,446000.0,0.0026912059955227,0.0012864360631852,0.0017285701622196,0.0077601699068779,0.0018289542713301,0.0021949154306892,1.311659192825112
3830210020,168000.0,3,1.0,1200,7210,1.0,0,0,4,6,1200,0,98030,47.3729,-122.183,1200,7650,6010,6450,43,0,440,253,283000.0,0.0024075114356793,0.0024145739800685,0.0026207740019219,0.0,0.0024642681123706,0.0035257371901672,0.5936395759717314
1088650310,530000.0,4,2.5,2320,5493,2.0,0,0,3,8,2320,0,98028,47.7727,-122.229,2450,5471,3173,3021,16,130,-22,282,442500.0,0.0038733093922744,0.0016366972980043,0.0046169981153891,0.0,0.0041547394554408,0.0019188405166805,1.1977401129943503
1338800785,1234000.0,4,3.0,2660,4600,1.5,0,0,3,8,1820,840,98112,47.6258,-122.305,2350,4600,1940,2250,114,-310,0,268,917500.0,0.0039712635784369,0.0034368728640955,0.0033880509771362,0.0063334087310563,0.0038430027097257,0.0035018137111232,1.3449591280653952
6300500476,420000.0,3,2.5,1509,1114,3.0,0,0,3,8,1509,0,98133,47.7049,-122.34,1509,2431,-395,922,6,0,1317,484,375000.0,0.0019326381471264,0.0003243327595884,0.0022830635717462,0.0,0.0020109784229611,0.0007470385039808,1.12
2025059150,1038000.0,4,1.75,1440,13296,1.0,0,0,4,8,1440,0,98004,47.634,-122.204,3520,10802,11856,7282,53,2080,-2494,315,1150000.0,0.0015705435825844,0.0032259488962722,0.0018902350979903,0.0,0.0041811184491851,0.0026793651675583,0.902608695652174
1761600050,397000.0,3,2.0,1100,9165,1.0,0,0,4,7,1100,0,98034,47.7304,-122.231,1510,8500,8065,6990,51,410,-665,543,446000.0,0.0010243344619636,0.0017274998562772,0.0012188635759241,0.0,0.0014535373419518,0.0018435554506777,0.8901345291479821
7787120500,515055.0,4,2.5,2400,8320,2.0,0,0,3,8,2400,0,98045,47.4808,-121.781,2430,9258,5920,6828,21,30,938,218,404750.0,0.0053177935588225,0.0007543878260664,0.0056608446451947,0.0,0.0058165280354257,0.001308764153716,1.2725262507720816
8665900328,459000.0,4,3.0,1900,9077,2.0,0,0,3,7,1900,0,98155,47.7684,-122.304,1900,12868,7177,10968,66,0,3791,442,377225.0,0.0024122695647757,0.0019930838212842,0.0029171080711774,0.0,0.0025005823724735,0.0029622979218103,1.2167804360792631
9324800650,587450.0,3,2.25,2190,8775,1.5,0,1,4,8,2190,0,98125,47.7303,-122.287,1910,8145,6585,6235,93,-280,-630,402,425000.0,0.0031096999920482,0.0028373238555399,0.0038265774148062,0.0,0.0028628900500331,0.0027671816670902,1.382235294117647
3630090050,690000.0,4,3.5,2710,2147,2.0,0,0,3,10,2220,490,98029,47.5468,-121.994,2650,2252,-563,-398,13,-60,105,320,574500.0,0.0037121253629938,0.0007720538790762,0.0031979256698357,0.013671875,0.003743836796971,0.0009980623762393,1.2010443864229765
3746700120,857326.0,3,3.5,3940,11632,2.0,0,0,3,10,3940,0,98166,47.438,-122.344,2015,11632,7692,9617,6,-1925,0,250,392500.0,0.0075899427479445,0.0034056816208842,0.0091957242216309,0.0,0.0042642795166444,0.0036560715398152,2.184270063694268
5450900010,993500.0,4,2.25,4070,23321,2.0,0,0,4,10,4070,0,98040,47.5563,-122.219,2820,10871,19251,8051,52,-1250,-12450,282,993750.0,0.004645445237962,0.0060344263232538,0.0058329427984653,0.0,0.0034497691590637,0.0030113890395522,0.999748427672956
8682250330,675000.0,3,3.5,2300,5611,1.0,0,0,3,8,2300,0,98053,47.7122,-122.026,2170,5926,3311,3756,16,-130,315,400,635000.0,0.0021945182841538,0.0003980653357809,0.0022610511331798,0.0,0.0021927719365611,0.0005100568826177,1.062992125984252
9510310030,535000.0,4,2.75,2710,45963,2.0,0,0,3,9,2710,0,98045,47.4745,-121.724,2710,33955,43253,31245,25,0,-12008,218,404750.0,0.0060046752268371,0.0041675393809486,0.0063920370785324,0.0,0.0064867452576147,0.0048000741887478,1.3218035824583076
7625703885,870000.0,4,3.0,2940,7108,2.0,0,1,3,9,2220,720,98136,47.5437,-122.395,2240,7950,4168,5710,9,-700,842,263,489950.0,0.0064735465346709,0.0045177487526615,0.0062427940721577,0.0073062326223286,0.0050934558188185,0.0052539786496812,1.7756913970813348
9136103136,580000.0,2,1.0,860,4013,1.0,0,0,3,7,860,0,98103,47.6652,-122.338,1490,4013,3153,2523,95,630,0,599,550000.0,0.0008695564251119,0.0019254676564136,0.0010218303357663,0.0,0.0016324473563117,0.0019299058948453,1.0545454545454545
7519000580,610000.0,4,1.0,1390,3708,1.5,0,0,4,7,1390,0,98117,47.685,-122.363,1430,3708,2318,2278,94,40,0,548,545000.0,0.0014980094794902,0.0014595305019438,0.0019003401472148,0.0,0.0016943529467522,0.0014576818220236,1.1192660550458715
1152700090,329000.0,4,2.5,2650,5880,2.0,0,0,3,9,2650,0,98042,47.3509,-122.165,2610,6490,3230,3880,15,-40,610,546,292000.0,0.0024474084253651,0.0005668182294912,0.0026271230128044,0.0,0.0024424777767275,0.0008069268891911,1.1267123287671232
7625704005,561000.0,3,2.0,2000,7000,2.0,0,0,3,7,2000,0,98136,47.5452,-122.393,1840,7000,5000,5160,104,-160,0,263,489950.0,0.0044037731528373,0.0044491054120189,0.0056241388037456,0.0,0.0041839101368866,0.0046261447229897,1.145014797428309
2397101375,595000.0,2,1.0,980,3600,1.0,0,0,3,6,980,0,98119,47.6366,-122.365,1690,3600,2620,1910,113,710,0,184,744975.0,0.0026555890665604,0.0054119061936259,0.0033498203744278,0.0,0.0049236685700967,0.0052488922650282,0.7986845196147522
7202340860,561000.0,3,2.5,2120,5277,2.0,0,0,3,7,2120,0,98053,47.6811,-122.034,2370,5257,3157,2887,15,250,-20,400,635000.0,0.0020227733749592,0.0003743701259875,0.0020840993053657,0.0,0.0023948707325576,0.0004524753681946,0.8834645669291339
1545800710,258000.0,3,1.75,1620,7540,1.0,0,0,3,7,1310,310,98038,47.3635,-122.052,1580,7540,5920,5960,32,-40,0,586,342750.0,0.001285141071998,0.0005061650092559,0.0010864048458632,0.005662100456621,0.0012717741007228,0.0006429624434892,0.7527352297592997
2856102105,1059500.0,5,3.25,3230,3825,2.0,0,0,3,9,2480,750,98117,47.6785,-122.392,1480,5100,595,3620,6,-1750,1275,548,545000.0,0.003480986056657,0.0015055836488498,0.0033905349389156,0.0038177653346907,0.0017535960567785,0.0020049021823949,1.9440366972477063
293760150,1040000.0,4,3.5,4320,8490,2.0,0,0,3,10,3280,1040,98029,47.5568,-122.029,4030,11008,4170,6978,15,-290,2518,320,574500.0,0.0059174839734809,0.0030529750504693,0.0047248631518294,0.0290178571428571,0.0056934574686012,0.0048786281694685,1.810269799825936
1441600020,960000.0,5,4.0,3720,15200,2.0,0,0,3,10,3720,0,98075,47.5956,-122.026,4100,19036,11480,14936,15,380,3836,358,739999.5,0.0034410766499823,0.0022325175880526,0.0036643856194535,0.0,0.0038396092214302,0.0035316887245698,1.2972981738501177
7640400250,506000.0,2,1.0,1570,8210,1.0,0,0,4,8,1150,420,98177,47.7221,-122.371,1680,8196,6640,6516,68,110,-14,254,557000.0,0.0026579535450667,0.0027114000335539,0.0024620417391006,0.0033983881930284,0.0030253916801728,0.0027568966143587,0.9084380610412928
3278602190,350000.0,3,3.25,1460,1592,2.0,0,0,3,8,1130,330,98126,47.5481,-122.374,1560,1701,132,141,14,100,109,352,396587.5,0.0026845983123805,0.0008867559215466,0.0025707350254684,0.0031645569620253,0.0031381131893288,0.0009632291109242,0.8825290761811706
8921000040,804100.0,4,2.5,3070,8086,2.0,0,0,3,10,3070,0,98059,47.5399,-122.16,3320,10738,5016,7418,15,250,2652,465,435000.0,0.002739090479207,0.0012061446851546,0.0029013174060143,0.0,0.0030347820761382,0.0018333189064896,1.8485057471264368
8691510310,374900.0,3,2.5,2480,4950,2.0,0,0,3,7,2480,0,98058,47.4389,-122.116,2230,5298,2470,3068,16,-250,348,451,335000.0,0.002676070320222,0.0005607304493965,0.0030396552442632,0.0,0.0024978186090846,0.0008514789585213,1.1191044776119403
9407150130,240000.0,4,2.5,1980,7264,2.0,0,0,3,7,1980,0,98038,47.3678,-122.019,1600,6380,5284,4780,24,-380,-884,586,342750.0,0.0015707279768865,0.0004876369532142,0.0016420470189382,0.0,0.0012878725070611,0.0005440451444908,0.700218818380744
2896400170,447000.0,3,2.5,1800,3074,2.0,0,0,3,7,1800,0,98072,47.7631,-122.149,1610,2929,1274,1319,17,-190,-145,272,517500.0,0.0027928756844484,0.0003669792675814,0.0031776799758496,0.0,0.0025120139799038,0.0004488963188969,0.863768115942029
7211402105,106000.0,1,1.0,560,5700,1.0,0,0,3,5,560,0,98146,47.511,-122.359,1120,5000,5140,3880,73,560,-700,281,312000.0,0.0012250130157632,0.0022511750541368,0.0014459150318359,0.0,0.0025905657147879,0.0021527060807058,0.3397435897435897
8682320420,755000.0,2,2.5,2170,6361,1.0,0,2,3,8,2170,0,98053,47.7109,-122.017,2310,7419,4191,5109,11,140,1058,400,635000.0,0.0020704802941799,0.0004512731422033,0.0021332525908696,0.0,0.0023342410937586,0.0006385609200372,1.188976377952756
7312400030,442000.0,2,1.0,1410,5000,1.0,0,2,4,7,940,470,98126,47.5531,-122.379,1450,5000,3590,3550,102,40,0,352,396587.5,0.0025926600140113,0.0027850374420433,0.00213848754331,0.0045070962792481,0.0029168359772607,0.0028313612901947,1.114508147634507
1099610260,212000.0,4,1.75,1250,12705,1.0,0,0,4,7,1250,0,98023,47.302,-122.382,1390,8550,11455,7160,49,140,-4155,492,269000.0,0.0012711972135357,0.0024599757778063,0.0014830088707658,0.0,0.0014332970368903,0.0017822175956362,0.7881040892193308
2916200091,734000.0,4,2.5,2180,7204,2.0,0,0,3,8,2180,0,98133,47.7221,-122.352,1500,7650,5024,6150,6,-680,446,484,375000.0,0.0027920153483999,0.0020973906643406,0.0032982628140536,0.0,0.0019989845158659,0.0023508204670726,1.9573333333333331
1105000745,227064.0,3,1.5,1570,10824,2.0,0,0,3,7,1570,0,98118,47.54,-122.275,1530,8125,9254,6595,112,-40,-2699,498,370000.0,0.0018584126315241,0.0037556704586539,0.0023635145612067,0.0,0.0019050061819318,0.0029352984358562,0.6136864864864865
5460900120,989900.0,5,2.25,3320,11350,1.0,0,0,5,8,1660,1660,98040,47.5749,-122.213,3320,11085,8030,7765,57,0,-265,282,993750.0,0.0037894049606963,0.0029368697212354,0.0023790380947057,0.0093067064350829,0.0040614303574792,0.0030706694419498,0.996125786163522
2591830350,397500.0,3,2.0,2130,8225,1.0,0,0,4,8,2130,0,98058,47.4396,-122.162,2580,8225,6095,5645,33,450,0,451,335000.0,0.0022983991056745,0.0009317187770276,0.0026106716412422,0.0,0.0028898529199275,0.0013218977791313,1.1865671641791045
7625701175,465000.0,4,2.0,2000,6250,1.5,0,0,3,7,1480,520,98136,47.5532,-122.389,1110,6250,4250,5140,90,-890,0,263,489950.0,0.0044037731528373,0.0039724155464454,0.0041618627147718,0.0052767235605706,0.0025239892673609,0.0041304863598122,0.9490764363710584
7985400089,275000.0,4,2.5,1840,1562,2.0,0,0,3,7,1400,440,98106,47.5345,-122.364,1840,1766,-278,-74,16,0,204,330,315000.0,0.0037389938448845,0.0008552376186286,0.0035603388425338,0.0044493882091212,0.00409014319947,0.0010496123091114,0.873015873015873
8888000055,530000.0,3,0.75,920,20412,1.0,1,2,5,6,920,0,98070,47.4781,-122.49,1162,54705,19492,53543,70,242,34293,116,466250.0,0.0041723734455641,0.0018215102043657,0.0046862026986415,0.0,0.0056498273933971,0.005856728396509,1.136729222520107
7905370440,469950.0,5,2.5,2310,8303,1.0,0,0,3,7,1300,1010,98034,47.7212,-122.211,1930,8303,5993,6373,45,-380,0,543,446000.0,0.0021511023701237,0.0015650225102749,0.001440475135183,0.0058930613578546,0.0018578324966669,0.0018008283419973,1.053699551569507
9144100298,380000.0,3,1.0,1260,7980,1.0,0,0,3,7,1260,0,98177,47.7013,-122.373,1760,7606,6720,5846,69,500,-374,254,557000.0,0.0021331346922191,0.0026354412019197,0.0026975413837102,0.0,0.0031694579506573,0.0025584377316755,0.6822262118491921
1535204165,510000.0,3,1.75,2060,58341,1.0,0,4,3,8,1100,960,98070,47.4193,-122.439,1230,14904,56281,13674,38,-830,-43437,116,466250.0,0.0093424883672414,0.0052061888513081,0.0056030684440278,0.0397071596972329,0.0059804541255409,0.0015956252631673,1.093833780160858
3034200275,380000.0,3,1.75,1240,8611,1.0,0,0,4,7,1240,0,98133,47.7175,-122.331,1700,8037,7371,6337,47,460,-574,484,375000.0,0.0015881188220256,0.0025070281802661,0.0018760760960671,0.0,0.002265515784648,0.0024697443259951,1.0133333333333334
1724069059,2000000.0,5,4.0,4580,4443,3.0,1,4,3,10,4580,0,98075,47.5682,-122.059,2710,4443,-137,1733,16,-1870,0,358,739999.5,0.0042365943701395,0.000652570766034,0.0045115285314777,0.0,0.00253788804636,0.0008242957030502,2.702704528854412
7301300050,375000.0,3,2.5,1930,6180,1.0,0,0,3,7,1330,600,98155,47.7481,-122.327,1940,6180,4250,4240,59,10,0,442,377225.0,0.002450358031588,0.0013569745527747,0.0020419756498242,0.0044017313476634,0.002553226211894,0.0014226764964864,0.9941016634634502
8691300860,851000.0,4,2.5,3130,13202,2.0,0,0,3,10,3130,0,98075,47.5878,-121.976,2840,10470,10072,7630,24,-290,-2732,358,739999.5,0.0028953144931303,0.0019390590261493,0.003083206179809,0.0,0.0026596317533809,0.0019424659038792,1.150000777027552
723069013,255500.0,2,1.0,1440,43560,1.0,0,0,4,7,1150,290,98027,47.4916,-122.082,1870,56628,42120,54758,55,430,13068,411,571000.0,0.0013925435097318,0.0032185918158362,0.0013232551155316,0.0017574692442882,0.0019142204055895,0.004834887003684,0.4474605954465849
9550200310,495000.0,2,1.0,970,4284,1.0,0,0,3,7,970,0,98103,47.6667,-122.333,2050,4284,3314,2234,115,1080,0,599,550000.0,0.0009807787585565,0.0020554954996451,0.0011525295647596,0.0,0.0022459846177443,0.0020602334546517,0.9
3131200640,700000.0,4,2.0,1830,4590,2.0,0,0,3,8,1830,0,98105,47.6593,-122.327,1650,4590,2760,2940,112,-180,0,229,675000.0,0.0037158718491234,0.0039138876501069,0.0047189029453174,0.0,0.0035517861178977,0.0040582298514192,1.037037037037037
7922720040,680000.0,4,2.5,2880,9202,1.0,0,0,3,8,1780,1100,98052,47.6658,-122.139,2500,10265,6322,7765,43,-380,1063,571,615000.0,0.0021307795545782,0.001449601839964,0.0014813483265757,0.0073328444770348,0.0018749217220181,0.0017888080735277,1.1056910569105691
1829700080,340000.0,3,1.0,1450,9586,2.0,0,0,3,7,1450,0,98155,47.7443,-122.326,1500,8592,8136,7092,70,50,-994,442,377225.0,0.001840942562592,0.0021048475829933,0.0022262140543196,0.0,0.0019741439782686,0.0019779347019112,0.9013188415401948
3066200460,572500.0,3,2.0,2290,11200,2.0,0,0,3,9,2290,0,98052,47.6517,-122.124,2250,10000,8910,7750,41,-40,-1200,571,615000.0,0.0016942656874945,0.0017643491205822,0.0019057795886844,0.0,0.0016874295498162,0.0017426284203874,0.9308943089430894
3935900030,775000.0,5,2.0,3540,9970,2.0,0,3,3,9,3540,0,98125,47.7108,-122.277,2280,7195,6430,4915,50,-1260,-2775,402,425000.0,0.0050266383433108,0.0032237172466932,0.0061854265061251,0.0,0.0034174813162699,0.0024444287409102,1.8235294117647056
3347400525,147000.0,3,1.0,1070,14000,1.0,0,0,3,7,1070,0,98178,47.4971,-122.279,920,12500,12930,11580,60,-150,-1500,258,279500.0,0.0023879664345652,0.0065311240717639,0.0031188970181012,0.0,0.0021604865791513,0.0059576435375057,0.5259391771019678
3336500140,208800.0,3,2.5,1390,2450,2.0,0,0,3,7,1390,0,98118,47.5298,-122.269,1390,2450,1060,1060,11,0,0,498,370000.0,0.001645346215171,0.0008500917058113,0.002092538369476,0.0,0.0017306918907746,0.0008851053745043,0.5643243243243243
4217401035,1482500.0,3,2.25,3290,5000,2.0,0,0,3,9,2730,560,98105,47.6582,-122.28,2340,4000,1710,1660,81,-950,-1000,229,675000.0,0.0066804472041617,0.0042634941722298,0.0070396748856375,0.0053496369889186,0.0050370784944732,0.0035365837485135,2.196296296296296
7215420590,530000.0,4,2.5,2940,35996,2.0,0,0,3,9,2940,0,98042,47.3401,-122.067,2890,35089,33056,32199,25,-50,-907,546,292000.0,0.0027152380266314,0.0034699301001301,0.002914619493451,0.0,0.0027045060439627,0.0043627515585252,1.8150684931506849
1895450230,325000.0,3,2.5,2260,8120,2.0,0,0,3,8,2260,0,98023,47.2924,-122.357,2250,7784,5860,5534,16,-10,-336,492,269000.0,0.0022983245620725,0.0015722159241076,0.0026812800383446,0.0,0.002320085131657,0.0016225475747874,1.20817843866171
908000010,360000.0,5,2.5,2880,6902,1.0,0,0,3,8,1680,1200,98058,47.4332,-122.144,2080,5586,4022,3506,44,-800,-1316,451,335000.0,0.0031076945654191,0.0007818508205525,0.0020591212945009,0.0108254397834912,0.0023298039044377,0.0008977654704228,1.0746268656716418
3216900080,325000.0,3,2.5,1880,6818,2.0,0,0,3,8,1880,0,98031,47.4206,-122.183,1970,7000,4938,5030,27,90,182,271,288400.0,0.0035902117079095,0.002072603123253,0.0040597210885235,0.0,0.0038033311002438,0.003042956989107,1.1269070735090152
3902300350,606000.0,4,2.25,2390,8858,1.0,0,0,4,8,1740,650,98033,47.6925,-122.184,2240,8858,6468,6618,41,-150,0,431,678000.0,0.0023305500000487,0.0019558241630615,0.0019615292262218,0.0046949713245597,0.0023546180998652,0.0020698113873274,0.8938053097345132
7893805650,475000.0,5,2.0,2050,10200,1.0,0,0,3,6,1430,620,98198,47.4136,-122.333,1940,8625,8150,6685,64,-110,-1575,275,266750.0,0.0042608823975673,0.0035145848379431,0.0035187787131112,0.0082965341897497,0.0041112147156056,0.0033006950402703,1.780693533270853
7853350090,648000.0,4,2.5,3290,6203,2.0,0,0,3,9,3290,0,98065,47.5441,-121.86,2990,6835,2913,3845,12,-300,632,305,500000.0,0.0041775125388864,0.0011797180544218,0.0043768624946785,0.0,0.003877803788316,0.0019795488134726,1.296
7569450090,298000.0,4,2.5,2420,3825,2.0,0,0,3,8,2420,0,98042,47.3687,-122.126,1880,4250,1405,2370,17,-540,425,546,292000.0,0.0022349918450504,0.0003687210421435,0.0023991085626365,0.0,0.0017593326514359,0.000528418995233,1.0205479452054795
1338300180,1395710.0,4,2.25,3960,8640,2.0,0,2,3,9,2630,1330,98112,47.6317,-122.304,3850,8640,4680,4790,95,-110,0,268,917500.0,0.0059121066806805,0.0064553438143012,0.0048959198186089,0.0100278971575058,0.0062959831627421,0.0065773196661096,1.5212098092643052
6413600275,446000.0,4,1.75,1730,5922,2.0,0,0,5,7,1730,0,98125,47.7188,-122.321,1700,6127,4192,4427,71,-30,205,402,425000.0,0.0024565209982846,0.0019148298430208,0.0030228214281346,0.0,0.0025481220340608,0.0020815865038995,1.0494117647058825
4139480190,1153000.0,3,3.25,3780,10623,1.0,0,1,3,11,2650,1130,98006,47.5506,-122.101,3850,11170,6843,7320,21,70,547,490,760184.5,0.0026740786278156,0.0016142951511424,0.0023511229051716,0.0039448420317681,0.0028228186394014,0.0018696992060724,1.516737055280659
7849202231,337000.0,3,2.5,1470,3976,2.0,0,0,3,7,1470,0,98065,47.526,-121.826,1490,4400,2506,2910,21,20,424,305,500000.0,0.0018665481556726,0.0007561758801194,0.0019556194125159,0.0,0.0019324172724384,0.0012743254980657,0.674
1314300046,308000.0,3,1.0,1010,8800,1.0,0,0,4,7,1010,0,98118,47.5483,-122.278,1400,4095,7790,2695,66,390,-4705,498,370000.0,0.0011955393362034,0.0030533906167918,0.0015204775202667,0.0,0.0017431429115716,0.0014793904116715,0.8324324324324325
2124069103,374000.0,3,1.75,1510,18439,1.0,0,0,3,7,1510,0,98027,47.5491,-122.046,1600,34326,16929,32726,49,90,15887,411,571000.0,0.0014602365970104,0.0013624337578559,0.0017374914995242,0.0,0.0016378356411461,0.0029307468264543,0.6549912434325744
7974200902,637000.0,4,2.5,1710,5000,1.0,0,0,3,8,1110,600,98115,47.6772,-122.285,1750,5304,3290,3554,41,40,304,576,570000.0,0.0016191541198003,0.0015925874609218,0.0013683684979382,0.0024497595152742,0.0017960304647818,0.0017421917521147,1.1175438596491227
930000234,525000.0,4,2.0,2260,7680,1.0,0,0,4,7,1130,1130,98177,47.7193,-122.361,1800,7680,5420,5880,73,-460,0,254,557000.0,0.0038260987336628,0.0025363644650054,0.0024192236218988,0.0091432825193384,0.0032414910858995,0.0025833291847578,0.9425493716337524
5466420030,253000.0,3,2.5,2020,6564,1.0,0,0,3,7,1310,710,98042,47.3545,-122.158,1710,5151,4544,3441,26,-310,-1413,546,292000.0,0.0018655717053726,0.0006327542276156,0.0012986909987826,0.0095855272039962,0.0016002440606146,0.0006404438222224,0.8664383561643836
2413900050,599000.0,4,2.0,3410,15143,2.0,0,0,4,8,3410,0,98052,47.6709,-122.052,2350,25936,11733,23586,48,-1060,10793,571,615000.0,0.0025229021809416,0.00238549452973,0.0028378639290018,0.0,0.001762426418697,0.004519681071117,0.9739837398373984
1556200155,675000.0,3,2.0,1510,3817,1.5,0,0,3,8,1510,0,98122,47.6088,-122.294,1510,3817,2307,2307,115,0,0,289,574000.0,0.0029208997144868,0.0037691283014433,0.0034939630796854,0.0,0.0030523673028797,0.0037124030442288,1.17595818815331
3353402390,171500.0,3,1.0,1150,6480,1.5,0,0,4,5,1150,0,98001,47.2642,-122.258,1100,7300,5330,6200,74,-50,820,358,260000.0,0.0016833636826727,0.0012094134923139,0.0018603417205087,0.0,0.0016769417460927,0.0018205755462786,0.6596153846153846
1721069036,412000.0,3,1.75,1950,52256,1.0,0,0,4,8,1950,0,98042,47.3133,-122.078,2450,51836,50306,49386,35,500,-420,546,292000.0,0.001800923180929,0.0050373560204578,0.0019331659905542,0.0,0.0022927473383075,0.0064449710675058,1.4109589041095891
3052700464,475000.0,3,2.25,1380,1621,2.0,0,0,3,8,1140,240,98117,47.678,-122.375,1460,1403,241,-57,13,80,-218,548,545000.0,0.0014872324328751,0.0006380525738001,0.0015585523509531,0.001221684907101,0.001729898812768,0.0005515446591961,0.8715596330275229
225069016,568000.0,3,1.75,1930,213008,1.0,0,2,3,7,1300,630,98053,47.6751,-121.993,2860,208652,211078,205792,40,930,-4356,400,635000.0,0.0018414870819204,0.0151115845738792,0.0012779854231016,0.0204280155642023,0.0028900127827488,0.017958891102253,0.8944881889763779
427000065,537500.0,5,2.5,4340,9108,1.0,0,0,5,8,2170,2170,98118,47.5384,-122.276,2030,6812,4768,4782,41,-2310,-2296,498,370000.0,0.0051372680387354,0.0031602592883795,0.0032667685336424,0.0120193639153216,0.0025275572217788,0.0024609542086218,1.4527027027027026
1180003435,275000.0,4,1.75,1690,6000,1.0,0,0,3,7,1690,0,98178,47.497,-122.227,1350,6000,4310,4650,63,-340,0,258,279500.0,0.0037716479200142,0.0027990531736131,0.0049261083743842,0.0,0.0031702792194068,0.0028596688980027,0.9838998211091234
985000900,198500.0,3,1.75,1520,7137,1.0,0,0,3,5,1520,0,98168,47.4924,-122.311,1240,8602,5617,7362,88,-280,1465,264,237000.0,0.0039017378134866,0.0023816285240143,0.0046436318088778,0.0,0.0031808573949804,0.0033345595974029,0.8375527426160337
7942600910,575000.0,1,1.0,1310,8667,1.5,0,0,1,6,1310,0,98122,47.6059,-122.313,1130,4800,7357,3670,102,-180,-3867,289,574000.0,0.0025340255801177,0.0085583010187607,0.0030311865128397,0.0,0.00228422188891,0.0046684659712597,1.0017421602787455
2131200065,265800.0,3,1.75,1460,7361,1.0,0,0,3,6,1460,0,98019,47.7436,-121.979,1460,7505,5901,6045,38,0,144,190,401250.0,0.0035385704175513,0.0009724818420954,0.0037737214580005,0.0,0.0036526755848659,0.001067091398902,0.662429906542056
7856570150,913888.0,5,2.25,2370,15512,2.0,0,0,4,9,2370,0,98006,47.5555,-122.15,2380,15100,13142,12720,39,10,-412,490,760184.5,0.0016766048539479,0.0023572386693515,0.002102702371795,0.0,0.0017450151589026,0.0025275253367676,1.2021923625119957
8562780290,329950.0,2,2.25,1260,1032,2.0,0,0,3,7,1170,90,98027,47.5323,-122.072,1240,809,-228,-431,12,-20,-223,411,571000.0,0.0012184755710153,7.625313943854489e-05,0.0013462682479757,0.0005454214896066,0.0012693226218882,6.907225376104399e-05,0.57784588441331
7856610130,840000.0,4,2.25,2720,8712,2.0,0,0,4,9,2720,0,98006,47.5616,-122.153,2470,8714,5992,6244,44,-250,2,490,760184.5,0.0019242047268938,0.0013238952609199,0.0024132280385158,0.0,0.0018110031270964,0.0014585997208339,1.104994905841937
7852090810,515000.0,3,2.5,2430,4203,2.0,0,0,3,8,2430,0,98065,47.5346,-121.875,2500,4798,1773,2298,19,70,595,305,500000.0,0.0030855183797854,0.0007993478933959,0.0032327586206896,0.0,0.0032423108597959,0.0013895940317544,1.03
1561900180,395000.0,3,2.5,2300,8938,2.0,0,0,3,9,2300,0,98031,47.4181,-122.211,2570,9694,6638,7124,31,270,756,271,288400.0,0.0043922802809531,0.0027170617066053,0.0049666800551085,0.0,0.0049617060546328,0.004214060721772,1.369625520110957
2025701360,260000.0,3,2.5,1510,6095,2.0,0,0,4,7,1510,0,98038,47.3498,-122.037,1520,6000,4585,4480,29,10,-95,586,342750.0,0.0011978784066154,0.0004091612375882,0.0012522681811094,0.0,0.0012234788817081,0.0005116412017155,0.7585703865791393
6819100020,1425000.0,4,4.25,4960,6000,2.5,0,0,3,11,3680,1280,98109,47.6437,-122.356,2160,4080,1040,1920,111,-2800,-1920,109,736000.0,0.0221457242232253,0.0152014958271893,0.0206195964610496,0.0281318681318681,0.0102764165754793,0.01038104543234,1.9361413043478264
8127700735,1095000.0,4,4.0,3530,8400,2.0,0,0,5,8,2630,900,98199,47.6402,-122.395,2340,8216,4870,5876,62,-1190,-184,316,689900.0,0.0051663324893526,0.0048866984069363,0.0052295639378815,0.0049900199600798,0.0037167635566568,0.0049222835177791,1.5871865487751848
8682280490,431500.0,2,2.0,1370,4866,1.0,0,0,3,8,1370,0,98053,47.704,-122.012,1365,4784,3496,3419,15,-5,-82,400,635000.0,0.0013071695866481,0.0003452122480681,0.0013468000228071,0.0,0.0013793242826755,0.0004117637742901,0.6795275590551181
2888000030,500000.0,4,2.25,2270,8196,1.0,0,0,5,7,1150,1120,98034,47.7214,-122.227,1920,10122,5926,8202,57,-350,1926,543,446000.0,0.0021138538442341,0.001544854208625,0.0012742664657388,0.0065348799215814,0.0018482064215547,0.0021953492084423,1.1210762331838564
7277100510,605000.0,3,1.75,1930,5400,2.0,0,2,3,9,1930,0,98177,47.77,-122.391,2100,6840,3470,4740,42,170,1440,254,557000.0,0.0032674205999864,0.0017833812644569,0.0041319483099689,0.0,0.003781739600216,0.0023007775551749,1.0861759425493716
4307350450,289950.0,3,2.5,1960,3480,2.0,0,0,3,7,1960,0,98056,47.4802,-122.18,2560,3500,1520,940,16,600,20,404,380000.0,0.0024059677821273,0.0008993224070829,0.0027137943829994,0.0,0.0033190071501267,0.001106099951616,0.7630263157894737
917000300,452000.0,4,1.0,1210,3760,1.5,0,0,3,6,1210,0,98103,47.6872,-122.344,1540,3800,2550,2260,120,330,40,599,550000.0,0.0012234456678901,0.0018040763488949,0.001437691518927,0.0,0.0016872274689396,0.0018274713183185,0.8218181818181818
1829300130,795000.0,4,2.5,3160,16564,2.0,0,0,3,10,3160,0,98074,47.6365,-122.04,3160,12415,13404,9255,33,0,-4149,435,645000.0,0.0027394196418122,0.0026099708639391,0.0029696764086462,0.0,0.0028048972085059,0.0021598974801138,1.2325581395348837
5315100806,940000.0,4,3.0,2720,11740,1.0,0,0,5,9,2720,0,98040,47.5833,-122.242,2640,11740,9020,9100,63,-80,0,282,993750.0,0.0031045727388837,0.0030377841874276,0.0038981829021685,0.0,0.0032295711276341,0.0032521117950826,0.9459119496855346
1705400244,535000.0,2,1.0,1390,5346,1.0,0,0,5,7,960,430,98118,47.5567,-122.279,1450,5040,3956,3590,112,60,-306,498,370000.0,0.001645346215171,0.001854934799701,0.0014452063558971,0.0023817172735429,0.0018053980155563,0.0018207881989803,1.445945945945946
7214810150,428000.0,3,1.75,2120,9350,1.0,0,0,3,7,1280,840,98072,47.7562,-122.145,2200,9000,7230,6800,41,80,-350,272,517500.0,0.0032893869172393,0.0011162186570874,0.0022596835383819,0.0107628834277221,0.0034325656868251,0.0013793331751697,0.8270531400966183
65000085,430000.0,3,2.0,1550,6039,1.0,0,0,5,7,830,720,98126,47.5436,-122.378,1330,6042,4489,4712,78,-220,3,352,396587.5,0.0028500872494451,0.0033637682224999,0.0018882390010078,0.0069044879171461,0.0026754426550046,0.0034214169830712,1.084250007879724
1336300610,1272500.0,4,1.75,2040,5000,2.0,0,0,4,9,2040,0,98102,47.6279,-122.315,3220,5600,2960,2380,99,1180,600,104,710000.0,0.0091189894014098,0.0133356092773166,0.0111931699715781,0.0,0.0158413893193614,0.0162997287259433,1.7922535211267605
3211240320,489950.0,4,2.25,2640,31941,1.0,0,0,4,9,2640,0,98092,47.3099,-122.116,2780,35365,29301,32585,34,140,3424,351,309780.0,0.0034255596053859,0.0028004620179283,0.0036425499505358,0.0,0.0037183770755365,0.0033350395961098,1.5816063012460455
9465200181,475000.0,4,1.5,2320,5534,1.5,0,0,4,7,1540,780,98103,47.6944,-122.355,1670,5913,3214,4243,105,-650,379,599,550000.0,0.0023457801235579,0.0026552549241448,0.0018297892059071,0.0052923335798565,0.0018296557617722,0.0028436415540046,0.8636363636363636
5309101050,489950.0,3,2.0,1580,4010,1.0,0,0,4,7,790,790,98117,47.6769,-122.371,1350,5350,2430,4000,111,-230,1340,548,545000.0,0.0017027733651759,0.0015784027272909,0.0010800494361868,0.0040213794858742,0.0015995639707102,0.0021031817011398,0.8989908256880734
7016100380,515000.0,4,2.5,1910,8947,1.0,0,0,4,8,1160,750,98011,47.7374,-122.183,1920,7350,7037,5430,50,10,-1597,194,470000.0,0.0043636795642717,0.0040687027309467,0.0030515956425318,0.0130264871906209,0.0043982727616342,0.0039809197495324,1.0957446808510638
7234601162,570000.0,3,3.5,1460,1021,2.0,0,0,3,8,1150,310,98122,47.6169,-122.309,1460,1245,-439,-215,14,0,224,289,574000.0,0.0028241811808946,0.0010081949163672,0.0026609652593631,0.0036560915202264,0.0029512955378837,0.0012108833612954,0.9930313588850174
3348401622,223000.0,3,2.0,1310,8440,1.0,0,0,5,6,1310,0,98178,47.5003,-122.269,1790,10775,7130,8985,69,480,2335,258,279500.0,0.0029235850740939,0.0039373347975491,0.0038184627044043,0.0,0.0042035554094356,0.0051354887293299,0.7978533094812165
305500140,365000.0,3,2.5,2200,4052,2.0,0,0,3,8,2200,0,98058,47.4362,-122.178,2310,5082,1852,2772,15,110,1030,451,335000.0,0.002373933348584,0.0004590060163545,0.0026964683618464,0.0,0.002587426451563,0.0008167640745952,1.0895522388059702
822069118,920000.0,3,3.25,3660,66211,2.0,0,0,3,10,3660,0,98038,47.4087,-122.062,3660,107153,62551,103493,17,0,40942,586,342750.0,0.0029034668663659,0.0044447866615181,0.0030352990350071,0.0,0.0029460083599024,0.0091373149479046,2.6841721371261853
464001115,620000.0,3,1.5,1620,6630,1.0,0,0,3,8,1280,340,98117,47.6948,-122.394,1880,5100,5010,3220,66,260,-1530,548,545000.0,0.001745881551636,0.0026096783246731,0.0017499535168597,0.0017307202850598,0.002227540936989,0.0020049021823949,1.1376146788990826
8129700743,672000.0,3,2.5,1780,1647,2.0,0,0,3,8,1080,700,98103,47.6597,-122.355,2000,1741,-133,-259,12,220,94,599,550000.0,0.0017997795775573,0.0007902430177207,0.001283228793753,0.0047495301357687,0.0021912045051164,0.0008372704118927,1.221818181818182
5141000510,392000.0,4,3.75,2220,3797,1.5,0,0,4,6,1330,890,98108,47.5574,-122.315,1490,4340,1577,2850,103,-730,543,185,345000.0,0.0070357810667765,0.0039338548773273,0.0055342876165113,0.0118335327748969,0.0051257353194124,0.0046384221669554,1.136231884057971
4233600190,1065000.0,3,4.0,3370,8252,2.0,0,0,3,10,3370,0,98075,47.5965,-122.013,3710,8252,4882,4542,6,340,0,358,739999.5,0.0031173194382904,0.0012120220484612,0.0033196181552576,0.0,0.0034743781003673,0.0015309673962571,1.439190161614974
7549802600,335000.0,4,2.0,1480,3132,1.0,0,0,5,6,740,740,98108,47.55,-122.312,1480,6420,1652,4940,110,0,3288,185,345000.0,0.0046905207111843,0.0032448863512744,0.0030792276964047,0.0098391171386783,0.0050913344112284,0.0068614447723165,0.9710144927536232
522059172,220000.0,3,1.0,1460,10200,1.0,0,0,4,7,1460,0,98055,47.4238,-122.197,1460,8500,8740,7040,63,0,-1700,260,297225.0,0.0031399064910039,0.0038896647032757,0.0035382788454547,0.0,0.0031429278741106,0.0043024402935175,0.7401799983177727
6713100031,476000.0,3,2.25,1570,7187,1.0,0,0,4,8,1170,400,98133,47.7604,-122.356,1660,8775,5617,7115,40,90,1588,484,375000.0,0.0020107633472421,0.002092441241618,0.001770168574515,0.0033376723073328,0.0022122095308916,0.0026965293592892,1.2693333333333334
7852010940,540000.0,3,2.5,2400,5817,2.0,0,0,3,8,2400,0,98065,47.5371,-121.87,2420,5817,3417,3397,22,20,0,305,500000.0,0.0030474255602818,0.0011063066133438,0.0031928480204342,0.0,0.0031385569122825,0.0016847162323292,1.08
2838000180,700000.0,3,2.5,2230,4006,2.0,0,0,3,8,2230,0,98133,47.73,-122.335,2230,4180,1776,1950,6,0,174,484,375000.0,0.0028560523976751,0.0011663169074609,0.0033739110437337,0.0,0.0029718236469206,0.0012845005950802,1.8666666666666667
3881900445,399950.0,5,2.75,1970,5400,1.0,0,0,3,7,1320,650,98144,47.5868,-122.308,1280,2150,3430,870,34,-690,-3250,340,452500.0,0.0030308438361559,0.0038777586842046,0.0026232062336919,0.0044283057302276,0.0021376549591089,0.0016114912065047,0.8838674033149171
3924500130,460000.0,2,2.5,1880,40575,1.0,0,0,3,9,1880,0,98024,47.5614,-121.899,1930,32935,38695,31005,33,50,-7640,79,465000.0,0.0100135822525233,0.0049492963948507,0.0107514583095047,0.0,0.0114312113530289,0.0052103182494343,0.989247311827957
323049148,319000.0,3,2.0,1640,9234,1.0,0,0,5,7,1060,580,98118,47.5162,-122.274,2230,10354,7594,8124,53,590,1120,498,370000.0,0.0019412717934392,0.0032039782903927,0.0015957486846364,0.0032125488805928,0.0027765776377176,0.0037405636929052,0.8621621621621621
1854900430,675000.0,4,2.5,2990,5400,2.0,0,0,3,8,2990,0,98074,47.6122,-122.009,2890,6538,2410,3648,15,-100,1138,435,645000.0,0.0025920458003223,0.0008508719310113,0.0028099153360292,0.0,0.0025652382698044,0.0011374474204578,1.0465116279069768
3831250150,435000.0,3,2.75,2692,6197,2.0,0,0,3,9,2692,0,98030,47.3569,-122.202,2336,5700,3505,3364,13,-356,-497,253,283000.0,0.0054008506540406,0.0020753280103307,0.0058792696776447,0.0,0.0047971085920814,0.0026270198671834,1.5371024734982333
3886902615,720000.0,4,2.5,2650,11520,2.0,0,0,3,8,2110,540,98033,47.683,-122.187,2000,7680,8870,5680,32,-650,-3840,431,678000.0,0.0025840826360373,0.0025435870804323,0.0023786360157057,0.0039004377157881,0.0021023375891653,0.0017945531107106,1.0619469026548674
9264960340,325000.0,4,2.5,2610,7091,2.0,0,0,3,9,2610,0,98023,47.3017,-122.349,2610,7773,4481,5163,33,0,682,492,269000.0,0.0026542597818625,0.0013729782164836,0.0030965225221591,0.0,0.0026912987527222,0.0016202546632609,1.20817843866171
255370420,318200.0,3,2.5,1990,3644,2.0,0,0,3,7,1990,0,98038,47.3531,-122.017,2580,3800,1654,1220,10,590,156,586,342750.0,0.0015786609464667,0.0002446240442611,0.0016503401857005,0.0,0.0020766944176361,0.0003240394277531,0.9283734500364698
8832900550,650000.0,3,2.5,2690,11575,1.0,0,3,3,8,2130,560,98028,47.7605,-122.267,2390,11782,8885,9392,63,-300,207,282,442500.0,0.0044910354591457,0.0034488933596213,0.0042388818904219,0.005804311774461,0.0040529907340831,0.0041322937246444,1.4689265536723164
6163901433,425000.0,4,2.25,2200,8384,1.0,0,0,3,7,1250,950,98155,47.753,-122.317,1750,8384,6184,6634,61,-450,0,442,377225.0,0.0027931542328982,0.0018409182282303,0.0019191500468272,0.0069694079671337,0.0023031679746467,0.0019300517389227,1.1266485519252436
3630020090,454280.0,3,2.5,1470,1741,2.0,0,0,3,8,1170,300,98029,47.5464,-121.999,1470,1583,271,113,16,0,-158,320,574500.0,0.0020135882965316,0.0006260576634708,0.0016853932584269,0.0083705357142857,0.0020767698458669,0.0007015687129604,0.790739773716275
5347200165,265000.0,3,1.0,1070,4800,1.0,0,0,3,6,970,100,98126,47.5187,-122.377,1120,1198,3730,78,73,50,-3602,352,396587.5,0.0019674795851008,0.0026736359443616,0.0022067371457561,0.0009589566551591,0.0022530043410565,0.0006783941651306,0.6682005862514577
9385200042,529500.0,3,2.25,1410,905,3.0,0,0,3,9,1410,0,98116,47.5818,-122.402,1510,1352,-505,-158,6,100,447,329,565500.0,0.0023103694624868,0.0005524325650756,0.0030182249412409,0.0,0.002708379295068,0.0008340515100835,0.9363395225464192
3585300445,892500.0,3,1.75,2120,56192,1.0,0,1,3,9,1720,400,98177,47.7665,-122.372,2240,20500,54072,18260,61,120,-35692,254,557000.0,0.0035890837678607,0.0185577333356231,0.0036823580793505,0.0032365601838366,0.0040338555735638,0.0068956052457728,1.6023339317773788
9557300190,440000.0,3,2.25,1900,7225,1.0,0,0,3,8,1220,680,98008,47.6394,-122.113,1900,7399,5325,5499,50,0,174,283,545000.0,0.0031469197452651,0.0025057823746215,0.0025164808871213,0.0057161590773446,0.003321794468338,0.0027535425018347,0.8073394495412844
2780900220,335000.0,2,2.0,1420,5185,1.0,0,0,3,7,1420,0,98038,47.3543,-122.022,2140,4890,3765,2750,16,720,-295,586,342750.0,0.0011264816803933,0.0003480723571607,0.0011776296802486,0.0,0.0017225294781943,0.0004169875793981,0.977388767323122
5379804690,249000.0,3,1.75,2120,18335,1.0,0,0,3,7,1380,740,98188,47.451,-122.273,2050,18333,16215,16283,59,-70,-2,135,265000.0,0.0086946892673904,0.0133983997918808,0.0068458153713358,0.0175172805605529,0.0092662068217362,0.0139130791139888,0.939622641509434
5652601455,775000.0,4,2.5,2300,6158,2.0,0,0,3,9,2300,0,98115,47.6943,-122.299,2170,6434,3858,4264,21,-130,276,576,570000.0,0.0021778096348191,0.0019614307168713,0.0028353581488809,0.0,0.0022270777763295,0.0021133600552613,1.3596491228070176
8961990090,535000.0,3,2.5,2070,4132,2.0,0,0,3,8,2070,0,98074,47.6036,-122.015,1530,5606,2062,4076,21,-540,1474,435,645000.0,0.0017944932463769,0.0006510745960997,0.0019453260018663,0.0,0.0013580673193082,0.0009753028814754,0.8294573643410853
510002065,700000.0,4,1.0,1980,4560,1.5,0,0,3,7,1980,0,98103,47.6606,-122.331,1810,3245,2580,1435,100,-170,-1315,599,550000.0,0.002002002002002,0.0021879223805747,0.0023525861218805,0.0,0.0019830400771303,0.001560564323143,1.2727272727272727
6638900461,700000.0,3,2.5,2050,4185,2.0,0,0,3,9,2050,0,98117,47.6922,-122.371,1150,5000,2135,3850,9,-900,815,548,545000.0,0.0022092945560826,0.0016472856393298,0.0028026599293456,0.0,0.0013625915306049,0.001965590374897,1.2844036697247707
7806210250,235000.0,4,1.75,1920,9350,1.0,0,0,4,7,1000,920,98002,47.292,-122.195,1910,8400,7430,6490,43,-10,-950,197,235000.0,0.0059887523744467,0.0063204630229253,0.0033370597166836,0.0439434466946885,0.0065577823022279,0.0056195748524025,1.0
5469502700,489990.0,5,2.25,2440,20828,1.5,0,0,4,8,2440,0,98042,47.3762,-122.158,2670,14472,18388,11802,45,230,-6356,546,292000.0,0.0022534628520343,0.0020077704224222,0.0024189359061294,0.0,0.0024986266911351,0.0017993599291794,1.6780479452054795
7960100260,349500.0,3,2.0,1270,3600,1.0,0,0,3,7,1270,0,98122,47.6099,-122.297,1660,3600,2330,1940,57,390,0,289,574000.0,0.0024566507532439,0.0035548498520293,0.0029386311994705,0.0,0.0033555825978677,0.0035013494784448,0.6088850174216028
7853240100,772500.0,5,2.75,3890,9130,2.0,0,0,3,9,3890,0,98065,47.5407,-121.86,3450,8361,5240,4911,16,-440,-769,305,500000.0,0.0049393689289568,0.0017363897850832,0.0051750744997871,0.0,0.0044743889865184,0.0024215080657563,1.545
9900000190,268950.0,3,1.0,1320,8100,1.0,0,0,3,6,880,440,98166,47.4697,-122.351,1000,8100,6780,7100,77,-320,0,250,392500.0,0.0025428234587022,0.0023715630269225,0.0020538673388414,0.0048539405171652,0.0021162677501957,0.0025459232696443,0.6852229299363057
7970800100,283200.0,4,2.5,1982,6406,2.0,0,0,3,8,1982,0,98030,47.3636,-122.192,2340,6501,4424,4161,16,358,95,253,283000.0,0.0039764063879303,0.0021453205154395,0.004328645059841,0.0,0.0048053228191227,0.0029961852906244,1.000706713780919
4137000700,273000.0,3,2.25,1830,7651,2.0,0,0,3,8,1830,0,98092,47.2642,-122.219,2160,8442,5821,6282,34,330,791,351,309780.0,0.0023745356355515,0.0006708097711145,0.0025249493975305,0.0,0.0028890987349492,0.0007961092682131,0.8812705791206663
2473250850,318500.0,4,2.0,1780,7350,1.0,0,0,5,7,900,880,98058,47.4562,-122.158,1480,7350,5570,5870,46,-300,0,451,335000.0,0.0019207278911271,0.0008325997581949,0.0011031006934826,0.0079386558412268,0.0016577450858499,0.0011812703558195,0.9507462686567164
7568700215,399500.0,4,1.5,1660,6617,1.0,0,0,5,7,1660,0,98155,47.739,-122.323,950,7440,4957,6490,73,-710,823,442,377225.0,0.0021075618302777,0.0014529289022185,0.0025486312621866,0.0,0.0012502911862367,0.0017127367530516,1.059049638809729
955000453,574000.0,2,2.25,1100,1114,2.0,0,0,3,8,900,200,98122,47.6199,-122.304,1230,1800,14,570,11,130,686,289,574000.0,0.0021278077390301,0.0011000285375446,0.0020824945508059,0.0023587687227267,0.002486365418902,0.0017506747392224,1.0
1954430190,528000.0,4,2.75,2050,7171,1.0,0,0,3,8,1540,510,98074,47.6194,-122.042,1960,7110,5121,5150,32,-90,-61,435,645000.0,0.0017771551473781,0.0011299264106077,0.0014472473637073,0.0057021466905187,0.0017397463698327,0.0012369610216358,0.8186046511627907
9225900055,380000.0,3,1.75,1750,10870,1.0,0,0,5,7,1750,0,98056,47.4989,-122.188,1230,10868,9120,9638,52,-520,-2,404,380000.0,0.0021481855197565,0.0028090903922389,0.0024230306991066,0.0,0.0015946792166624,0.0034345983640465,1.0
2296700260,460000.0,3,2.5,1730,8490,1.0,0,0,3,7,1210,520,98034,47.7187,-122.219,1870,7400,6760,5530,51,140,-1090,543,446000.0,0.0016109987447246,0.0016002699159622,0.0013407499335165,0.0030340513921628,0.0018000760459933,0.0016049776864723,1.031390134529148
8682301600,540000.0,3,2.5,1810,3930,2.0,0,0,3,8,1810,0,98053,47.7169,-122.02,1560,5100,2120,3540,12,-250,1170,400,635000.0,0.0017269904757906,0.000278808905653,0.0017793489352415,0.0,0.001576370608772,0.0004389622175751,0.8503937007874016
8910500238,343000.0,3,3.25,1210,1173,2.0,0,0,3,8,1000,210,98133,47.7114,-122.356,1650,1493,-37,-157,18,440,320,484,375000.0,0.0015496965924605,0.0003415101678611,0.0015129645936025,0.0017522779613497,0.0021988829674525,0.0004587941120705,0.9146666666666666
2824079053,440000.0,3,2.5,1910,66211,2.0,0,0,3,7,1910,0,98024,47.5385,-121.911,2330,67268,64301,64938,23,420,1057,79,465000.0,0.0101733734586806,0.0080763490720755,0.0109230241335925,0.0,0.01380037432775,0.0106418001519036,0.946236559139785
6072400280,619850.0,4,2.5,2270,9247,1.0,0,0,5,8,1500,770,98006,47.5602,-122.176,2270,9163,6977,6893,48,0,-84,490,760184.5,0.0016058620331062,0.0014051950732009,0.0013308242859462,0.0026880781986385,0.0016643631977769,0.0015337559378014,0.8153941576025294
6150200060,370037.0,2,1.0,1250,9270,1.0,0,0,4,7,1250,0,98133,47.7284,-122.339,1130,6800,8020,5670,72,-120,-2470,484,375000.0,0.0016009262318807,0.0026988910963961,0.0018912057420032,0.0,0.001505901668619,0.0020896181929535,0.9867653333333334
203900460,407450.0,3,2.0,1810,10860,1.0,0,0,3,7,1810,0,98053,47.6393,-121.967,1420,11982,9050,10562,53,-390,1122,400,635000.0,0.0017269904757906,0.0007704490369954,0.0017793489352415,0.0,0.0014349014515746,0.0010313029982324,0.6416535433070866
2125400010,490000.0,3,2.25,1630,7573,1.0,0,2,3,7,1230,400,98034,47.7273,-122.211,1550,7695,5943,6145,37,-80,122,543,446000.0,0.0015178774300007,0.0014274256859343,0.0013629110894424,0.002333885686279,0.0014920416424009,0.0016689599050547,1.0986547085201794
6400700389,875000.0,5,3.0,2960,15152,2.0,0,0,3,9,2960,0,98033,47.6689,-122.179,1850,9453,12192,7603,16,-1110,-5699,431,678000.0,0.0028863715481775,0.0033455235627353,0.0033368543158715,0.0,0.0019446622699779,0.0022088425202535,1.2905604719764012
9842300540,339000.0,3,1.0,1100,4128,1.0,0,0,4,7,720,380,98126,47.5296,-122.379,1510,4538,3028,3028,78,410,410,352,396587.5,0.0020226425641223,0.002299326912151,0.0016379904587055,0.0036440352896049,0.0030375326383887,0.0025697435069807,0.8547924480726196
9558021000,348000.0,4,2.5,2070,3808,2.0,0,0,3,8,2070,0,98058,47.4498,-122.12,1900,2992,1738,1092,17,-170,-816,451,335000.0,0.0022336554688949,0.00043136596996,0.00253713159501,0.0,0.0021281862588613,0.0004808654291989,1.0388059701492538
7855300200,1242500.0,4,2.75,2680,8500,1.0,0,4,4,9,1480,1200,98006,47.5634,-122.156,2940,8650,5820,5710,58,260,150,490,760184.5,0.0018959075985571,0.0012916792605394,0.0013130799621336,0.0041892127770989,0.0021556069609974,0.0014478870306649,1.6344716315578651
9264910280,280500.0,4,2.75,2660,7754,1.5,0,0,3,8,1590,1070,98023,47.3078,-122.337,2250,7754,5094,5504,34,-410,0,492,269000.0,0.0027051076704039,0.0015013500339323,0.0018863872836141,0.0076186949958702,0.002320085131657,0.001616294179715,1.0427509293680297
984000780,304000.0,4,2.0,1810,8750,1.0,0,0,2,7,1110,700,98058,47.4307,-122.17,1810,8750,6940,6940,53,0,0,451,335000.0,0.0019530997095168,0.0009911901883272,0.0013604908552952,0.0063148398737032,0.0020273774360732,0.0014062742331184,0.9074626865671642
6117502230,1637500.0,3,3.5,4660,21164,2.0,1,4,3,12,4660,0,98166,47.4418,-122.354,3140,24274,16504,21134,45,-1520,3110,250,392500.0,0.0089769373617821,0.0061965135681219,0.0108761611352284,0.0,0.0066450807356146,0.0076295977095491,4.171974522292993
1545807810,118000.0,1,1.0,670,7957,1.0,0,0,4,6,670,0,98038,47.3594,-122.056,1600,7957,7287,6357,42,930,0,586,342750.0,0.0005315089618757,0.000534158485232,0.000555642173075,0.0,0.0012878725070611,0.0006785215070084,0.3442742523705324
126039599,475000.0,4,2.25,1800,7200,1.0,0,0,3,7,1230,570,98177,47.7717,-122.376,2260,7498,5400,5238,41,460,298,254,557000.0,0.0030473352745987,0.0023778416859425,0.0026333142079076,0.0046120982619671,0.0040698721411849,0.0025221096650148,0.8527827648114902
6388930390,650000.0,5,3.5,3960,25245,2.0,0,0,3,9,2500,1460,98056,47.525,-122.172,2640,13675,21285,11035,24,-1320,-11570,404,380000.0,0.0048610369475634,0.006523963841037,0.0034614724272952,0.0158000108219252,0.0034227261235681,0.0043216905252426,1.7105263157894737
4178310040,777000.0,4,2.5,3170,9900,2.0,0,0,4,8,3170,0,98007,47.6181,-122.147,2540,12400,6730,9860,41,-630,2500,139,560000.0,0.010410167153788,0.0066567554973705,0.0120660779537149,0.0,0.0085723928450894,0.0092975686857886,1.3875
3424069154,362500.0,4,1.75,1450,8450,1.0,0,0,3,7,1450,0,98027,47.5289,-122.028,1540,8450,7000,6910,60,90,0,411,571000.0,0.0014022139507716,0.0006243595235035,0.0016684521021921,0.0,0.0015764168046031,0.0007214592636351,0.6348511383537653
9113200180,852500.0,4,2.5,3480,6315,2.0,0,0,3,9,2360,1120,98052,47.6841,-122.161,3620,5233,2835,1613,20,140,-1082,571,615000.0,0.0025746919617821,0.0009948093478997,0.0019640348599543,0.0074661689220718,0.0027148866534822,0.0009119174523887,1.386178861788618
1727850350,1190000.0,4,2.5,3480,12164,1.5,0,0,4,11,3480,0,98005,47.6404,-122.171,3960,16855,8684,12895,36,480,4691,168,765475.0,0.007796694470396,0.0036331747926246,0.0095890750675781,0.0,0.0091793945772031,0.0054621415743023,1.5545902870766517
1722059021,336500.0,3,2.0,1830,12891,1.0,0,0,3,7,1830,0,98031,47.3924,-122.192,2320,8709,11061,6389,26,490,-4182,271,288400.0,0.0034947273539757,0.0039187337726392,0.0039517497829776,0.0,0.0044790498236374,0.0037858732025905,1.1667822468793343
2260000340,700000.0,4,1.75,2340,9100,1.0,0,0,3,8,1610,730,98052,47.6401,-122.108,2470,11000,6760,8530,45,130,1900,571,615000.0,0.0017312583880948,0.001433533660473,0.0013398712392061,0.0048663422438504,0.0018524226613538,0.0019168912624262,1.1382113821138211
1623301185,625000.0,3,1.75,1780,4500,1.0,0,0,4,7,920,860,98117,47.6827,-122.362,1360,4000,2720,2640,98,-420,-500,548,545000.0,0.0019183142974766,0.0017712748809998,0.0012577790902429,0.0043777042504454,0.0016114125927154,0.0015724722999176,1.146788990825688
6181430800,330000.0,4,2.5,3504,6000,2.0,0,0,3,7,3504,0,98001,47.3012,-122.285,2790,5231,2496,2441,14,-714,-769,358,260000.0,0.0051291359513786,0.0011198273076981,0.0056683803379674,0.0,0.0042533340650897,0.0013045795455594,1.2692307692307692
8079100640,653000.0,4,2.5,2160,7000,2.0,0,0,4,9,2160,0,98029,47.5659,-122.013,2300,7440,4840,5140,31,140,440,320,574500.0,0.0029587419867404,0.002517176131129,0.0031114952463267,0.0,0.0032493677860503,0.0032973286319808,1.1366405570060922
6141100445,499000.0,2,1.5,1540,6549,2.0,0,0,3,7,1540,0,98133,47.7189,-122.353,1470,6552,5009,5082,40,-70,3,484,375000.0,0.001972341117677,0.001906692318263,0.0023299654741479,0.0,0.0019590048255486,0.0020134085882693,1.3306666666666669
446000020,439500.0,4,1.0,1360,5500,1.5,0,0,3,7,1360,0,98115,47.6878,-122.285,1530,5790,4140,4260,70,170,290,576,570000.0,0.0012877483058061,0.001751846207014,0.0016765596010774,0.0,0.0015702437777807,0.0019018269692202,0.7710526315789473
7212680020,299500.0,3,1.75,1820,8813,2.0,0,0,3,7,1820,0,98003,47.2622,-122.303,1780,7349,6993,5569,26,-40,-1464,276,269500.0,0.0034141409214803,0.0030052466498302,0.0039643297451066,0.0,0.0034297054884921,0.002724925972041,1.111317254174397
7137950720,339100.0,4,2.5,2350,10655,2.0,0,0,3,8,2350,0,98092,47.3284,-122.171,2210,7028,8305,4818,28,-140,-3627,351,309780.0,0.003049267072976,0.0009341887480362,0.0032424213574845,0.0,0.0029559760204805,0.0006627642664063,1.0946478145780876
7974200820,865000.0,5,3.0,2900,6730,1.0,0,0,5,8,1830,1070,98115,47.6784,-122.285,2370,6283,3830,3913,43,-530,-447,576,570000.0,0.0027459338873807,0.0021436227224008,0.0022559588749791,0.004368737802239,0.002432338400876,0.0020637614590001,1.5175438596491229
8019201061,235000.0,3,2.0,1090,8400,1.0,0,0,4,6,1090,0,98168,47.4942,-122.322,1100,10850,7310,9750,59,10,2450,264,237000.0,0.0027979567215134,0.0028030936810593,0.0033299728103137,0.0,0.0028217283342568,0.0042059953071171,0.9915611814345991
6061500130,1029280.0,4,3.25,3600,18645,2.0,0,1,3,10,3000,600,98059,47.5294,-122.154,3970,10957,15045,6987,7,370,-7688,465,435000.0,0.0032119627769202,0.0027811733433969,0.002835163588939,0.009573958831977,0.0036289412175509,0.0018707091877823,2.36616091954023
7701960990,870000.0,4,2.5,3190,14565,2.0,0,0,3,11,3190,0,98077,47.713,-122.072,3420,20475,11375,17055,30,230,5910,196,652475.0,0.0057000419909049,0.0013494575208561,0.0060851733511373,0.0,0.0062745385829083,0.0022894144074889,1.3333844208590366
2483200010,690000.0,3,1.75,2070,6000,1.0,0,3,3,8,1340,730,98136,47.5226,-122.382,2200,6000,3930,3800,65,130,0,263,489950.0,0.0045579052131866,0.0038135189245876,0.0037681729985096,0.0074077080754165,0.0050025012506253,0.0039652669054197,1.4083069700989896
3943600140,370000.0,4,2.5,1812,5026,2.0,0,0,3,8,1812,0,98055,47.4513,-122.202,2440,6007,3214,3567,9,628,981,260,297225.0,0.0038969250422597,0.0019166132155553,0.0043913433342219,0.0,0.0052525643923493,0.0030405598639011,1.2448481789889814
4014400381,495000.0,4,2.75,2656,21195,2.0,0,0,3,9,2656,0,98001,47.3162,-122.272,1860,16510,18539,14650,6,-796,-4685,358,260000.0,0.0038878382097207,0.0039557899644436,0.0042965805301488,0.0,0.0028355560433931,0.0041174934615151,1.9038461538461535
164000267,311300.0,2,1.0,1000,7228,1.0,0,0,4,7,1000,0,98133,47.7294,-122.352,1100,7228,6228,6128,73,100,0,484,375000.0,0.0012807409855045,0.0021043780846549,0.0015129645936025,0.0,0.0014659219783016,0.0022211412203923,0.8301333333333333
7215720160,900000.0,3,2.5,3400,16603,2.0,0,0,3,10,3400,0,98075,47.6012,-122.023,3400,12601,13203,9201,20,0,-4002,358,739999.5,0.0031450700564355,0.0024385848364761,0.0033491696521887,0.0,0.003184066183625,0.0023378235773431,1.2162170379844852
3811000250,610000.0,3,2.25,2320,38186,2.0,0,0,3,8,2320,0,98053,47.6645,-122.068,2875,37523,35866,34648,40,555,-663,400,635000.0,0.0022136010518421,0.0027090577280578,0.0022807124473814,0.0,0.0029051701924485,0.0032296429980534,0.9606299212598424
1180002745,285000.0,3,1.75,2380,6000,1.5,0,0,3,7,1320,1060,98178,47.498,-122.222,1290,6000,3620,4710,85,-1090,0,258,279500.0,0.0053115515086591,0.0027990531736131,0.0038476112746669,0.0100942767355489,0.0030293779207665,0.0028596688980027,1.0196779964221825
7518503335,475000.0,2,1.0,1490,3825,1.0,0,0,3,7,860,630,98117,47.6799,-122.381,1460,3825,2335,2365,91,-30,0,548,545000.0,0.0016057799456405,0.0015055836488498,0.0011757500191401,0.0032069228811402,0.001729898812768,0.0015036766367962,0.8715596330275229
6384500581,555000.0,3,1.75,2040,6000,1.0,0,0,5,7,1120,920,98116,47.5688,-122.397,1530,6250,3960,4720,62,-510,250,329,565500.0,0.0033426622010447,0.0036625363430429,0.002397455272475,0.0064277230489764,0.0027442518685126,0.003855637528123,0.9814323607427056
9328510100,699000.0,4,2.5,2550,7312,2.0,0,0,3,9,2550,0,98008,47.6441,-122.113,2330,7480,4762,5150,32,-220,168,283,545000.0,0.0042234975528558,0.002535955809444,0.005259857591934,0.0,0.0040735690059092,0.0027836867027603,1.2825688073394494
6979900360,635000.0,4,2.5,3080,35430,2.0,0,0,3,9,3080,0,98053,47.6325,-121.97,2640,28972,32350,26332,23,-440,-6458,400,635000.0,0.0029387462239973,0.0025135367753912,0.0030278423870408,0.0,0.0026677041071527,0.002493649679919,1.0
625100181,535000.0,4,2.5,2280,65836,2.0,0,0,3,8,2280,0,98077,47.7237,-122.076,2300,97574,63556,95274,16,20,31738,196,652475.0,0.0040740112035308,0.0060997518258211,0.0043492775048881,0.0,0.004219718930026,0.0109102476872441,0.8199547875397525
7159200005,3200000.0,7,4.5,6210,8856,2.5,0,2,5,11,4760,1450,98109,47.6307,-122.354,2940,5400,2646,2460,110,-3270,-3456,109,736000.0,0.0277268039165784,0.0224374078409315,0.0266709997702708,0.0318681318681318,0.0139873447832913,0.0137396189545676,4.3478260869565215
7853361230,480000.0,4,2.5,2430,5000,2.0,0,0,3,7,2430,0,98065,47.515,-121.873,2430,5441,2570,3011,11,0,441,305,500000.0,0.0030855183797854,0.0009509254025647,0.0032327586206896,0.0,0.0031515261557217,0.0015758193261308,0.96
705700960,315000.0,3,2.5,1660,10763,2.0,0,0,3,7,1660,0,98038,47.3812,-122.029,2010,7983,9103,5973,26,350,-2780,586,342750.0,0.0013168729503189,0.0007225270549896,0.0013766656825442,0.0,0.0016178898369955,0.0006807386188825,0.9190371991247264
3925000020,265000.0,3,2.0,1690,9516,1.0,0,0,3,7,1690,0,98022,47.2132,-122.001,1850,9516,7826,7666,23,160,0,233,280000.0,0.0039477311057851,0.0005501690457411,0.0041978816843192,0.0,0.0044072803506765,0.0007932113908356,0.9464285714285714
1061400360,280000.0,3,1.0,1090,10710,1.0,0,0,4,7,1090,0,98056,47.5,-122.169,1090,10440,9620,9350,58,0,-270,404,380000.0,0.0013380126951626,0.0027677422355914,0.0015092019783007,0.0,0.0014131710131398,0.0032993381413918,0.7368421052631579
5101407250,630000.0,4,2.25,2900,9680,2.0,0,0,3,7,1990,910,98125,47.7037,-122.308,1850,7540,6780,5690,73,-1050,-2140,402,425000.0,0.0041178675693789,0.0031299481392167,0.0034771182901663,0.0068973358093,0.0027729563311839,0.0025616390141019,1.4823529411764709
3294700030,280950.0,3,1.75,1390,8700,1.0,0,3,4,7,840,550,98055,47.4725,-122.202,1390,10875,7310,9485,108,0,2175,260,297225.0,0.0029893630291065,0.0033176551880881,0.0020357220754671,0.0105058068459657,0.0029922395513793,0.0055045927284709,0.9452435023971738
7853380570,701000.0,4,2.5,3340,5314,2.0,0,0,3,10,3340,0,98065,47.5167,-121.885,3220,5500,1974,2280,10,-120,186,305,500000.0,0.0042410005713922,0.0010106435178458,0.0044433801617709,0.0,0.0041760963874172,0.0015929068725822,1.402
629650370,250000.0,3,2.5,1750,6351,2.0,0,0,3,7,1750,0,98001,47.2589,-122.256,1398,6092,4601,4694,8,-352,-259,358,260000.0,0.0025616403866759,0.0011853372051984,0.0028309547920785,0.0,0.0021312405100342,0.0015193077024561,0.9615384615384616
8948500025,380000.0,4,2.5,2400,9398,1.0,0,0,4,7,1310,1090,98056,47.4952,-122.178,1330,8249,6998,6919,62,-1070,-1149,404,380000.0,0.0029460829985232,0.002428687351082,0.0018138115519027,0.0117958984903414,0.0017243279334642,0.0026069195716801,1.0
4189800050,335000.0,3,1.0,1060,10050,1.0,0,0,4,7,1060,0,98028,47.7355,-122.231,1570,9938,8990,8368,53,510,-112,282,442500.0,0.0017697017050908,0.0029945035217447,0.0021094905182381,0.0,0.0026624248755273,0.0034855487213984,0.7570621468926554
2794700120,496000.0,3,3.5,3090,27598,2.0,0,2,4,9,2020,1070,98070,47.3541,-122.453,2180,17085,24508,14905,25,-910,-10513,116,466250.0,0.0140137325508621,0.0024627688918325,0.0102892711426694,0.0442569384125408,0.0105995040599017,0.0018291235655672,1.063806970509383
1321700030,575000.0,4,2.5,4620,20793,2.0,0,0,4,11,4620,0,98023,47.2929,-122.342,3640,20793,16173,17153,29,-980,0,492,269000.0,0.0046983449012279,0.0040259957770899,0.0054812007863506,0.0,0.0037533821685474,0.004334228124686,2.137546468401487
7277100640,715000.0,3,2.5,3050,6000,1.0,0,3,3,8,1720,1330,98177,47.7701,-122.389,2340,7200,2950,4860,36,-710,1200,254,557000.0,0.0051635403264034,0.0019815347382854,0.0036823580793505,0.0107615626112567,0.0042139384116693,0.0024218711107104,1.2836624775583485
4441300170,1300000.0,4,2.5,3110,11857,2.0,0,4,3,11,2040,1070,98117,47.6952,-122.402,3110,11570,8747,8460,30,0,-287,548,545000.0,0.0033516614972766,0.0046671125031144,0.0027889884174951,0.0054466785441588,0.0036849214436361,0.0045483761275117,2.385321100917431
8155870200,349900.0,4,2.5,2052,3723,2.0,0,0,3,8,2052,0,98003,47.2824,-122.295,2052,5250,1671,3198,6,0,1527,276,269500.0,0.0038493500938888,0.0012695487662904,0.0044696728774499,0.0,0.0039537953159471,0.0019466405433685,1.298330241187384
2895110062,249000.0,3,1.0,1752,14626,2.0,0,2,3,8,1752,0,98032,47.3755,-122.278,1800,9000,12874,7200,15,48,-5626,123,250000.0,0.0081599955287695,0.0114382241269419,0.009912866357361,0.0,0.0087612984244265,0.0078746289081127,0.996
2225059214,1578000.0,4,3.25,4670,51836,2.0,0,0,4,12,4670,0,98005,47.635,-122.164,4230,41075,47166,36845,32,-440,-10761,168,765475.0,0.0104628055105602,0.0154825097460122,0.0128680978636753,0.0,0.0098052623892851,0.0133110332343202,2.0614651033671905
9358001732,400000.0,3,2.5,1390,2815,2.0,0,0,3,8,1390,0,98126,47.566,-122.366,1390,3700,1425,2310,21,0,885,352,396587.5,0.0025558846946637,0.0015679760798704,0.003162231580001,0.0,0.0027961393161327,0.002095207354744,1.0086046584927664
1422069069,426500.0,4,2.75,2100,88426,1.0,0,0,3,6,2100,0,98038,47.399,-122.011,2150,63162,86326,61012,30,50,-25264,586,342750.0,0.0016659236118493,0.005936093780964,0.001741565020086,0.0,0.0017305786813634,0.0053860469304597,1.2443471918307805
8043700105,2300000.0,4,4.0,4360,8175,2.5,1,4,3,10,3940,420,98008,47.5724,-122.104,2670,8525,3815,5855,13,-1690,350,283,545000.0,0.0072213526786083,0.0028352624100389,0.008126995651851,0.0035305688418893,0.004667995384454,0.0031725841097635,4.220183486238532
2140950130,440000.0,4,2.5,2990,7928,2.0,0,0,3,9,2990,0,98010,47.3139,-122.024,2810,7401,4938,4591,9,-180,-527,99,359999.0,0.0142104187558516,0.0014826237728099,0.0152020499888145,0.0,0.0142259753146421,0.0016092173954639,1.2222256172933814
2459500070,278000.0,3,2.25,1590,9425,1.0,0,0,3,7,1170,420,98058,47.4291,-122.16,1590,9394,7835,7804,35,0,-31,451,335000.0,0.0017157063746584,0.0010676534314268,0.0014340309015274,0.0037889039242219,0.0017809558692576,0.001509776016676,0.8298507462686567
1332200130,324950.0,4,2.5,2641,8615,2.0,0,0,3,7,2641,0,98031,47.4038,-122.213,2641,8091,5974,5450,22,0,-524,271,288400.0,0.0050434835747814,0.0026188729696134,0.0057030443589311,0.0,0.0050987804242355,0.0035172235712664,1.126733703190014
8078600330,580000.0,3,2.25,1940,5980,1.0,0,0,3,7,1520,420,98027,47.5476,-122.075,1910,6309,4040,4399,33,-30,329,411,571000.0,0.001876065561722,0.0004418544320179,0.0017489980657462,0.0025453002848312,0.0019551662966181,0.0005386611235827,1.0157618213660244
8965500880,1108000.0,4,2.5,3320,9380,2.0,0,3,3,10,3320,0,98006,47.5655,-122.114,2870,11779,6060,8909,32,-450,2399,490,760184.5,0.0023486616519439,0.0014254060545717,0.0029455577528943,0.0,0.0021042829857356,0.0019716371484626,1.457540899610555
3298201290,370000.0,3,1.0,940,7910,1.0,0,0,4,6,940,0,98008,47.6181,-122.117,1000,7700,6970,6700,61,60,-210,283,545000.0,0.0015568971371311,0.0027433548212119,0.0019389278966345,0.0,0.0017483128780726,0.0028655598410767,0.6788990825688074
6114400136,608250.0,4,2.75,3030,21780,2.0,0,0,3,8,3030,0,98166,47.4481,-122.338,3020,28027,18750,25007,34,-10,6247,250,392500.0,0.0058369356665664,0.0063768694723916,0.0070718386780562,0.0,0.0063911286055911,0.0088092088244843,1.5496815286624204
7787110510,397000.0,4,2.5,2320,11717,2.0,0,0,3,8,2320,0,98045,47.484,-121.78,2320,9714,9397,7394,23,0,-2003,218,404750.0,0.0051405337735284,0.001062399297839,0.0054721498236882,0.0,0.0055532284124229,0.0013732269376968,0.980852378011118
9109000050,275000.0,3,1.0,1200,7800,1.0,0,0,4,7,1200,0,98126,47.5196,-122.371,1230,7070,6600,5840,66,30,-730,352,396587.5,0.0022065191608607,0.0043446584095876,0.0027299840978426,0.0,0.0024742815531246,0.0040035448643353,0.693415702713777
7937900220,716500.0,5,2.75,3630,38461,2.0,0,0,3,11,3630,0,98058,47.4289,-122.094,4440,50378,34831,45938,20,810,11917,451,335000.0,0.0039169900251636,0.004356818952372,0.0044491727970466,0.0,0.0049732352575497,0.0080966038075477,2.138805970149254
1972201305,500000.0,2,2.0,1250,3360,1.0,0,0,3,7,1250,0,98103,47.6526,-122.349,1250,3360,2110,2110,63,0,0,599,550000.0,0.001263890152779,0.001612153333055,0.0014852185112882,0.0,0.0013695028156977,0.0016158693761974,0.9090909090909092
8082400011,570000.0,2,1.0,910,4301,1.0,0,0,4,7,910,0,98117,47.6814,-122.399,1810,4301,3391,2491,97,900,0,548,545000.0,0.0009807112419684,0.0016929451695956,0.0012441075783924,0.0,0.0021446005829522,0.0016908008404864,1.0458715596330277
2923059064,199000.0,2,1.0,1140,15120,1.0,0,0,4,6,990,150,98055,47.4521,-122.196,2320,11250,13980,8930,88,1180,-3870,260,297225.0,0.0024517078080441,0.0057658559130911,0.0023992438746576,0.0028652200488997,0.0049942415533813,0.005694406270832,0.6695264530238035
1370802115,1925000.0,3,4.5,3950,6134,2.0,0,3,3,11,2880,1070,98199,47.6413,-122.405,3050,5281,2184,2231,22,-900,-853,316,689900.0,0.005781023607066,0.0035684533366842,0.0057266707760831,0.0059325792858726,0.0048444995076082,0.0031638971832268,2.790259457892448
2979800750,552000.0,2,1.0,1150,5000,1.0,0,0,4,7,1050,100,98115,47.6846,-122.317,1463,4320,3850,2857,96,313,-680,576,570000.0,0.0010889048174095,0.0015925874609218,0.0012944026331847,0.0004082932525457,0.0015014814685576,0.0014189797076047,0.968421052631579
259600560,405000.0,3,1.0,1220,7771,1.0,0,0,3,7,1220,0,98008,47.6326,-122.119,1420,7674,6551,6254,57,200,-97,283,545000.0,0.0020206537311702,0.002695146689714,0.0025164808871213,0.0,0.0024826042868631,0.0028558839247303,0.7431192660550459
1126049103,415000.0,3,1.5,1860,9003,1.0,0,0,3,7,1490,370,98028,47.7624,-122.26,2090,11574,7143,9484,65,230,2571,282,442500.0,0.0031053256334613,0.0026825388264942,0.0029652272379007,0.003834991708126,0.0035442471272944,0.0040593420106123,0.9378531073446328
3362400432,547500.0,3,3.5,1650,2262,3.0,0,0,3,8,1650,0,98103,47.6823,-122.347,1620,3166,612,1546,10,-30,904,599,550000.0,0.0016683350016683,0.0010853246545745,0.0019604884349004,0.0,0.0017748756491443,0.0015225721562622,0.9954545454545456
7768700315,1230000.0,3,1.75,2200,14630,1.5,0,1,3,8,2200,0,98004,47.6074,-122.213,2850,15803,12430,12953,72,650,1173,315,1150000.0,0.0023994415845039,0.0035496113381816,0.0028878591774851,0.0,0.0033852805625504,0.0039198303779785,1.0695652173913044
3649100015,480000.0,3,2.25,1820,15000,1.0,0,0,3,7,1480,340,98028,47.7401,-122.249,1930,13600,13180,11670,42,110,-1400,282,442500.0,0.0030385444370428,0.00446940824141,0.0029453263839551,0.0035240464344941,0.0032729172036738,0.0047699197636364,1.0847457627118644
9523102750,870000.0,3,1.5,2420,5000,2.0,0,0,4,8,2200,220,98103,47.6744,-122.353,2070,5000,2580,2930,95,-350,0,599,550000.0,0.0024468913357802,0.0023990376979985,0.0026139845798673,0.0014927094712415,0.0022678966627955,0.0024045675241033,1.5818181818181818
7202261260,571000.0,3,2.5,2510,5186,2.0,0,0,3,7,2510,0,98053,47.6895,-122.041,2530,5186,2676,2656,19,20,0,400,635000.0,0.0023948873448809,0.0003679142454749,0.0024674949322962,0.0,0.0025565497693547,0.0004463643255577,0.8992125984251969
142000165,749950.0,4,2.75,2600,6050,2.0,0,0,5,8,1960,640,98116,47.5656,-122.4,1990,6050,3450,4060,71,-610,0,329,565500.0,0.0042602557464295,0.0036930574792349,0.0041955467268313,0.0044714595123314,0.0035693210577387,0.003732257127223,1.3261715296198056
2560803248,270000.0,4,2.5,1660,8063,1.0,0,0,4,7,1660,0,98198,47.3761,-122.32,1060,8437,6403,7377,42,-600,374,275,266750.0,0.0034502755024203,0.0027782448576799,0.0040847361285067,0.0,0.0022463338136814,0.0032287494556244,1.0121836925960637
6169901197,900000.0,3,1.5,2160,2260,2.0,0,2,5,8,1620,540,98119,47.6321,-122.371,2570,2400,100,-170,103,410,140,184,744975.0,0.0058531350854801,0.0033974744437763,0.0055374581699726,0.0070606694560669,0.0074874723225731,0.0034992615100188,1.2080942313500451
6163901352,289950.0,3,1.0,1090,8280,1.0,0,0,3,6,1090,0,98155,47.7562,-122.318,1060,7609,7190,6549,73,-30,-671,442,377225.0,0.001383880960845,0.0018180824105137,0.0016734988408333,0.0,0.0013950617446431,0.0017516416604798,0.7686394061899396
255550150,352000.0,3,2.5,2090,3002,2.0,0,0,3,7,1670,420,98019,47.745,-121.984,2090,3163,912,1073,15,0,161,190,401250.0,0.0050654877895083,0.0003966024303722,0.0043165170101787,0.0163360560093348,0.0052288301180614,0.0004497281938344,0.8772585669781932
192460060,330000.0,3,1.75,1510,15744,1.0,0,0,3,7,1510,0,98045,47.476,-121.755,1470,15744,14234,14274,35,-40,0,218,404750.0,0.0033457784474258,0.0014275338862488,0.003561614755935,0.0,0.0035186404164921,0.0022256624363907,0.8153180975911056
9211520410,245000.0,3,2.5,1460,11593,2.0,0,0,3,7,1460,0,98023,47.2984,-122.385,1640,9703,10133,8063,31,180,-1890,492,269000.0,0.0014847583454097,0.0022446673901699,0.0017321543610545,0.0,0.0016910842737411,0.0020225564129191,0.9107806691449816
1370802600,1015000.0,3,3.25,3620,4000,2.0,0,0,3,10,2730,890,98199,47.6393,-122.403,1910,5000,380,3090,15,-1710,1000,316,689900.0,0.0052980520145769,0.0023269992413982,0.0054284066731621,0.0049345752938567,0.0030337685441087,0.0029955474183174,1.471227714161473
8001450060,370000.0,5,3.0,2670,9920,1.0,0,0,3,8,1400,1270,98001,47.3211,-122.277,1890,10341,7250,8451,30,-780,421,358,260000.0,0.0039083313328141,0.0018514478153942,0.0022647638336628,0.0195414679181412,0.0028812908182865,0.0025789824279544,1.4230769230769231
8126300410,650000.0,4,1.75,2390,12000,1.0,0,0,3,8,1470,920,98052,47.7061,-122.163,2110,12000,9610,9890,41,-280,0,571,615000.0,0.0017682510886951,0.0018903740577666,0.0012233606966664,0.0061329244717018,0.0015824339333832,0.0020911541044649,1.056910569105691
8068000730,315000.0,4,2.0,1780,5336,1.5,0,0,5,6,930,850,98178,47.5094,-122.263,1910,10304,3556,8394,102,130,4968,258,279500.0,0.0039725049098375,0.0024892912890666,0.0027108170344244,0.0080944671936006,0.0044853580067162,0.0049110047208367,1.1270125223613596
319500570,780000.0,4,2.5,2730,10281,2.0,0,2,3,9,2730,0,98074,47.6227,-122.029,2750,7220,7551,4470,24,20,-3061,435,645000.0,0.0023666505133377,0.0016199656153198,0.0025655748720266,0.0,0.0024409706719592,0.0012560982526316,1.2093023255813953
3226059128,850000.0,5,3.5,3450,28324,1.0,0,0,5,8,2350,1100,98033,47.6991,-122.196,2640,14978,24874,12338,48,-810,-13346,431,678000.0,0.0033641830544636,0.0062538680960212,0.0026491917710467,0.0079453360877165,0.0027750856176983,0.0034998458974249,1.2536873156342183
7888400560,208000.0,4,2.75,1810,8677,1.5,0,0,3,7,1810,0,98198,47.3668,-122.31,1740,8677,6867,6937,58,-70,0,275,266750.0,0.0037620473851692,0.0029898090822385,0.0044538387907212,0.0,0.0036873781469865,0.003320594882832,0.7797563261480788
8860310120,740000.0,4,2.0,2800,8540,1.0,0,0,4,8,1730,1070,98052,47.6869,-122.126,2470,9400,5740,6930,43,-330,860,571,615000.0,0.0020715912336177,0.0013453162044439,0.0014397374185258,0.0071328578094793,0.0018524226613538,0.0016380707151642,1.2032520325203253
8691510290,385000.0,3,2.5,2230,8296,2.0,0,0,3,7,2230,0,98058,47.4386,-122.116,2480,5940,6066,3460,16,250,-2356,451,335000.0,0.0024063051669738,0.0009397615774129,0.0027332383849625,0.0,0.0027778431168295,0.0009546593079684,1.1492537313432836
1623089086,760000.0,4,2.75,3980,285318,2.0,0,2,3,9,3980,0,98045,47.4803,-121.795,2100,105415,281338,103315,14,-1880,-179903,218,404750.0,0.0088186743183807,0.0258702434804842,0.0093875673699479,0.0,0.0050266291664173,0.0149020709941645,1.877702285361334
5017000470,1975000.0,6,4.5,4800,9097,2.0,0,0,3,10,3580,1220,98112,47.6259,-122.291,2180,6037,4297,3857,13,-2620,-3060,268,917500.0,0.0071661899159764,0.0067967896618864,0.0066644079660152,0.0091985222046294,0.0035649982583838,0.004595749863924,2.1525885558583107
6190701483,364000.0,4,1.75,2010,8625,1.0,0,0,4,7,1340,670,98133,47.7496,-122.355,1500,8400,6615,6900,63,-510,-225,484,375000.0,0.0025742893808641,0.0025111041754494,0.0020273725554274,0.0055906011147825,0.0019989845158659,0.0025812930618837,0.9706666666666668
8165500780,338000.0,3,2.5,1690,1760,2.0,0,0,3,8,1410,280,98106,47.5387,-122.367,1740,1760,70,20,6,50,0,330,315000.0,0.0034341845640516,0.00096364802099,0.0035857698342662,0.0028314288603498,0.0038678528081945,0.001046046242376,1.073015873015873
7137970210,289999.0,3,2.0,1490,9285,1.0,0,0,3,8,1490,0,98092,47.3248,-122.169,2040,6681,7795,4641,25,550,-2604,351,309780.0,0.0019333650803125,0.0008140725035679,0.0020558331160221,0.0,0.0027285932496743,0.0006300409880279,0.936145006133385
3298300130,474905.0,4,1.5,1340,6200,1.0,0,0,5,6,1340,0,98008,47.6214,-122.119,1210,7178,4860,5968,61,-130,978,283,545000.0,0.0022194065571869,0.0021502907574607,0.00276400359733,0.0,0.0021154585824679,0.0026712972128895,0.8713853211009174
7334500800,299500.0,3,1.0,1380,10875,1.0,0,0,3,7,1380,0,98045,47.4653,-121.745,1040,10875,9495,9835,43,-340,0,218,404750.0,0.0030577312963229,0.0009860537990952,0.0032549856709869,0.0,0.0024893782538447,0.0015373525784901,0.7399629400864731
3904100220,276000.0,2,2.0,1480,6075,1.0,0,0,5,7,740,740,98118,47.5317,-122.276,1230,6053,4595,4823,101,-250,-22,498,370000.0,0.0017518794233475,0.0021078804542057,0.0011140132326706,0.004098769261446,0.0015314755580236,0.0021867521762754,0.745945945945946
1022059082,307000.0,3,1.75,1890,13860,1.0,0,0,5,7,1890,0,98042,47.4156,-122.149,1500,14536,11970,13036,54,-390,676,546,292000.0,0.0017455101599773,0.0013360715409435,0.0018736839600756,0.0,0.0014037228601882,0.0018073172975782,1.0513698630136987
423049067,160000.0,2,1.0,930,7742,1.0,0,0,3,6,930,0,98168,47.507,-122.302,2240,8723,6812,6483,87,1310,981,264,237000.0,0.0023872474779885,0.0025835180093763,0.0028411694620108,0.0,0.0057460649715775,0.0033814651671873,0.6751054852320675
4137070830,269100.0,3,2.5,2190,7904,2.0,0,0,3,8,2190,0,98092,47.2617,-122.21,2190,7669,5714,5479,25,0,-235,351,309780.0,0.0028416573999224,0.0006929918221003,0.0030216607544217,0.0,0.002929225106268,0.0007232127431801,0.8686809994189425
2225300585,370000.0,3,2.75,1750,9166,1.0,0,0,4,7,1170,580,98155,47.7696,-122.325,1810,8760,7416,6950,41,60,-406,442,377225.0,0.0022218272307145,0.0020126260114455,0.0017963244438303,0.0042550069694079,0.0023821337337774,0.0020166094027866,0.9808469746172708
1787250210,379000.0,4,2.75,2410,5225,2.0,0,0,3,8,2410,0,98058,47.4244,-122.151,2300,5378,2815,3078,19,-110,153,451,335000.0,0.0026005360773125,0.0005918821410297,0.002953858523659,0.0,0.0025762254712532,0.0008643363229384,1.1313432835820896
3307700150,950000.0,3,1.0,1720,9830,1.0,0,0,4,7,1720,0,98040,47.5905,-122.245,3200,8923,8110,5723,74,1480,-907,282,993750.0,0.0019631857025294,0.0025435620581272,0.00246502742343,0.0,0.0039146316698595,0.0024717711709984,0.9559748427672956
1924069058,965000.0,4,3.25,5010,49222,2.0,0,0,5,9,3710,1300,98027,47.5489,-122.092,3140,54014,44212,50874,42,-1870,4792,411,571000.0,0.004844890960942,0.0036369496409341,0.0042689360683674,0.0078783104054299,0.0032142524457492,0.0046117042208269,1.6900175131348512
8087800400,385000.0,4,2.5,1950,7350,1.0,0,0,3,7,1150,800,98052,47.656,-122.134,2050,9068,5400,7018,57,100,1718,571,615000.0,0.0014427153234123,0.001157854110382,0.0009570508851472,0.0053329778014799,0.0015374358120548,0.0015802154516073,0.6260162601626016
7635800313,300000.0,4,1.5,1460,8760,1.0,0,0,3,7,1460,0,98166,47.4698,-122.36,1610,9375,7300,7765,62,150,615,250,392500.0,0.0028125168558373,0.0025648014957828,0.0034075526303505,0.0,0.0034071910778151,0.0029466704509773,0.7643312101910829
7214710300,542126.0,4,2.5,2360,43088,2.0,0,0,3,8,2360,0,98077,47.7661,-122.071,2850,39216,40728,36366,43,490,-3872,196,652475.0,0.0042169589650582,0.0039921335845279,0.0045018837331298,0.0,0.0052287821524235,0.0043849414116769,0.8308762787846278
1085623740,491000.0,5,3.5,2815,4900,2.0,0,0,3,9,2815,0,98030,47.3424,-122.179,2798,4900,2085,2102,9,-17,0,253,283000.0,0.0056476205761977,0.0016409726078135,0.0061478990128417,0.0,0.0057458518153441,0.0022583153244208,1.734982332155477
2159800120,801501.0,4,2.25,2250,13500,2.0,0,0,4,9,2250,0,98007,47.621,-122.151,2730,13500,11250,10770,40,480,0,139,560000.0,0.0073889199041082,0.0090773938600507,0.00856425091352,0.0,0.0092136348295646,0.0101223530046892,1.4312517857142857
6772200055,780000.0,4,3.0,2440,3600,1.5,0,0,5,8,1480,960,98103,47.6853,-122.331,1770,4000,1160,2230,91,-670,400,599,550000.0,0.0024671135782246,0.0017273071425589,0.0017584987173652,0.0065136413290542,0.001939215987028,0.0019236540192827,1.4181818181818182
3361401210,209000.0,2,1.0,1070,6120,1.0,0,0,3,6,1070,0,98168,47.4989,-122.317,1130,6120,5050,4990,58,60,0,264,237000.0,0.0027466180660728,0.0020422539676289,0.0032688723917758,0.0,0.0028986845615547,0.0023724139428162,0.8818565400843882
8161020050,445000.0,3,2.5,2690,21883,2.0,0,0,3,8,2690,0,98014,47.6462,-121.904,2370,21781,19193,19411,26,-320,-102,123,415000.0,0.0103228084178857,0.0018244691130877,0.01102829639469,0.0,0.0100089531564099,0.0022576384071962,1.072289156626506
269000615,875000.0,3,2.0,2220,6641,1.0,0,2,4,7,1220,1000,98199,47.6426,-122.388,1800,5900,4421,4100,73,-420,-741,316,689900.0,0.0032490816221991,0.0038634004905314,0.0024258813704241,0.0055444666223109,0.002859048889736,0.0035347459536145,1.2682997535874765
6372000101,483500.0,3,2.0,1200,2016,1.0,0,1,4,7,600,600,98116,47.5811,-122.404,1730,4520,816,2790,89,530,2504,329,565500.0,0.0019662718829674,0.0012306122112624,0.0012843510388259,0.0041919932928107,0.0031029776029587,0.0027883970603385,0.8549955791335102
8018600765,240500.0,3,1.75,1460,10584,1.0,0,0,3,7,990,470,98168,47.492,-122.317,1220,12012,9124,10792,23,-240,1428,264,237000.0,0.0037477218471648,0.0035318980381347,0.0030244707176244,0.007551413881748,0.0031295532434484,0.0046564438367825,1.0147679324894514
4306500070,475000.0,4,2.75,2200,16288,1.0,0,0,3,7,1290,910,98059,47.4793,-122.122,2650,6620,14088,3970,40,450,-9668,465,435000.0,0.0019628661414512,0.0024295924600294,0.0012191203432438,0.0145205042284984,0.0024223411149899,0.001130245032684,1.091954022988506
2215800050,785000.0,4,2.5,3440,56192,2.0,0,0,3,9,3440,0,98053,47.6969,-122.046,3150,44431,52752,41281,26,-290,-11761,400,635000.0,0.0032822360423866,0.0039864707446453,0.0033817460426689,0.0,0.0031830560369436,0.0038242216253101,1.236220472440945
6421100592,510000.0,3,1.75,1610,11950,1.0,0,2,3,7,1210,400,98052,47.6705,-122.138,1610,9363,10340,7753,36,0,-2587,571,615000.0,0.0011911649593302,0.0018824974991926,0.001006983974807,0.0026664889007399,0.0012074495889796,0.0016316229900088,0.8292682926829268
3306300630,212000.0,3,1.75,1100,9750,1.0,0,0,4,6,1100,0,98023,47.2955,-122.362,1100,9900,8650,8800,53,0,150,492,269000.0,0.0011186535479114,0.0018878208448337,0.0013050478062739,0.0,0.0011342638421434,0.0020636203738946,0.7881040892193308
8081030090,1288000.0,4,3.5,3700,13175,2.0,0,0,4,11,3700,0,98006,47.5471,-122.133,3880,15508,9475,11628,31,180,2333,490,760184.5,0.0026174843711423,0.0020021028538361,0.003282699905334,0.0,0.0028448146287993,0.0025958187365955,1.69432552229097
1868901295,660000.0,5,2.25,2540,3750,1.5,0,0,4,7,1510,1030,98115,47.6729,-122.299,1780,3750,1210,1970,95,-760,0,576,570000.0,0.0024050593358438,0.0011944405956914,0.0018614742629609,0.0042054205012207,0.0018268195584638,0.0012317532184069,1.1578947368421053
1284000010,330000.0,4,1.75,1550,50094,1.0,0,3,4,6,1550,0,98022,47.2194,-122.059,1720,50094,48544,48374,53,170,0,233,280000.0,0.0036207001266077,0.0028961925365024,0.0038501281720088,0.0,0.0040975795692776,0.0041756128008114,1.1785714285714286
5393600507,329445.0,2,1.5,830,1119,2.0,0,0,3,7,830,0,98144,47.5828,-122.314,1480,3622,289,2142,15,650,2503,340,452500.0,0.0012769545096494,0.0008035577717824,0.0016494402833062,0.0,0.0024716635464697,0.0027148005348651,0.7280552486187846
4443801495,470000.0,5,1.5,2180,4268,1.5,0,0,4,7,1340,840,98117,47.6848,-122.389,1530,3880,2088,2350,96,-650,-388,548,545000.0,0.0023493961620781,0.0016799558204683,0.0018319825879625,0.0042758971748536,0.0018128391668049,0.0015252981309201,0.8623853211009175
4351300978,787888.0,4,2.25,2580,21115,2.0,0,0,4,9,2580,0,98040,47.5566,-122.219,2690,10165,18535,7475,43,110,-10950,282,993750.0,0.0029447785537941,0.0054636127016639,0.0036975411351451,0.0,0.0032907372474756,0.0028158191138854,0.7928432704402516
425069020,1090000.0,4,2.5,4340,141570,2.5,0,0,3,11,4340,0,98053,47.6805,-122.048,2720,97138,137230,94418,28,-1620,-44432,400,635000.0,0.0041409605883598,0.0100435055402805,0.0042665051817393,0.0,0.0027485436255513,0.0083607670374147,1.7165354330708662
1324079041,275000.0,3,1.0,1370,17859,1.0,0,0,4,7,1150,220,98024,47.5617,-121.859,1460,47044,16489,45584,90,90,29185,79,465000.0,0.0072971317478494,0.002178422287508,0.0065766899233672,0.0170741171905316,0.0086474448577317,0.0074423625846785,0.5913978494623656
6791100280,430000.0,3,1.75,1720,15225,1.0,0,0,4,7,1020,700,98075,47.579,-122.051,1860,13588,13505,11728,50,140,-1637,358,739999.5,0.0015910354403144,0.0022361894919803,0.0010047508956566,0.0106253794778384,0.0017418715004537,0.0025209385579667,0.5810814737036984
1922059298,175000.0,3,1.0,1460,11880,1.0,0,0,2,7,1460,0,98030,47.3762,-122.219,1310,9315,10420,8005,59,-150,-2565,253,283000.0,0.0029291389134098,0.0039785213430255,0.0031886083690049,0.0,0.0026901593560046,0.0042931035197918,0.6183745583038869
3901100055,350000.0,3,1.75,1010,8580,1.0,0,0,3,7,1010,0,98033,47.6703,-122.174,1500,8580,7570,7080,59,490,0,431,678000.0,0.0009848767782632,0.0018944424609469,0.0011385888037264,0.0,0.001576753191874,0.002004852303372,0.5162241887905604
324059076,430000.0,4,1.5,1560,6534,1.0,0,0,4,7,1560,0,98007,47.6012,-122.152,1560,6969,4974,5409,58,0,435,139,560000.0,0.0051229844668483,0.0043934586282645,0.0059378806333739,0.0,0.0052649341883226,0.0052253835621984,0.7678571428571429
8835800350,1950000.0,4,3.25,7420,167869,2.0,0,3,3,12,7420,0,98045,47.4548,-121.764,5610,169549,160449,163939,18,-1810,1680,218,404750.0,0.0164408450860263,0.0152209531218689,0.0175014446947271,0.0,0.0134282807731434,0.0239684222832576,4.817788758492897
3904900530,485000.0,3,2.5,1580,6065,2.0,0,0,3,8,1580,0,98029,47.5692,-122.021,1770,6700,4485,4930,35,190,635,320,574500.0,0.0021642649717823,0.0021809533193282,0.0022760011524056,0.0,0.0025006004266561,0.0029693685261118,0.8442123585726719
293070010,849990.0,4,2.75,3300,4987,2.0,0,0,3,9,3300,0,98074,47.6175,-122.056,3520,5453,1687,1933,6,220,466,435,645000.0,0.0028607863348038,0.0007857959851765,0.0031012443508014,0.0,0.0031244424601078,0.0009486847329086,1.3178139534883722
524059093,775000.0,3,1.75,1640,18730,1.5,0,0,4,7,1640,0,98004,47.5975,-122.196,1670,12154,17090,10484,74,30,-6576,315,1150000.0,0.0017886746357211,0.0045443759647397,0.0021527677504889,0.0,0.0019836556278804,0.0030147198895115,0.6739130434782609
1898700310,220000.0,4,1.5,1240,9600,1.0,0,0,3,7,1240,0,98023,47.3206,-122.397,1240,9592,8360,8352,49,0,-8,492,269000.0,0.0012610276358274,0.0018587774472208,0.0014711447997997,0.0,0.0012786246947799,0.0019994188511512,0.8178438661710037
6303400395,325000.0,1,0.75,410,8636,1.0,0,0,2,4,410,0,98146,47.5077,-122.357,1190,8636,8226,7446,67,780,0,281,312000.0,0.0008968845293981,0.0034107276785132,0.0010586163625941,0.0,0.0027524760719622,0.003718153942595,1.0416666666666667
7211300050,472000.0,5,2.25,1780,7245,1.0,0,0,4,8,1330,450,98052,47.6946,-122.12,1780,7653,5465,5873,44,0,408,571,615000.0,0.0013169401413713,0.0011413133373766,0.0011068501541268,0.0029998000133324,0.0013349442660768,0.0013336335301225,0.767479674796748
5540000050,299000.0,3,2.5,2210,10119,1.0,0,0,4,7,1450,760,98030,47.3783,-122.22,2110,10119,7909,8009,54,-100,0,253,283000.0,0.0044338335607094,0.0033887758813195,0.0031667685856556,0.0187376725838264,0.0043330047642516,0.0046636515852682,1.0565371024734982
7212680080,300000.0,3,1.75,1700,8481,2.0,0,0,3,7,1700,0,98003,47.2623,-122.305,1830,6600,6781,4770,27,130,-1881,276,269500.0,0.0031890327288553,0.002892034135619,0.0037029453663084,0.0,0.0035260455303037,0.0024472052545204,1.1131725417439704
8682220390,750000.0,2,2.5,2630,7957,2.0,0,0,3,8,2630,0,98053,47.7106,-122.023,2305,7220,5327,4915,17,-325,-737,400,635000.0,0.0025093839510107,0.00056449935427,0.0025854628175056,0.0,0.0023291886238587,0.0006214327864495,1.1811023622047243
1312900180,225000.0,3,1.0,1250,7820,1.0,0,0,3,7,1250,0,98001,47.3397,-122.291,1300,7920,6570,6620,53,50,100,358,260000.0,0.0018297431333399,0.0014595082576998,0.0020221105657703,0.0,0.0019818402453823,0.0019751997707571,0.8653846153846154
1105000787,240000.0,3,2.25,1410,7290,1.0,0,0,3,7,940,470,98118,47.5396,-122.274,1550,7375,5880,5825,40,140,85,498,370000.0,0.0016690202614324,0.0025294565450468,0.0014150978901492,0.0026032723687563,0.0019299082235257,0.0026643478110079,0.6486486486486487
1761300650,295000.0,4,2.0,1710,8814,1.0,0,0,5,7,1030,680,98031,47.395,-122.174,1710,7272,7104,5562,45,0,-1542,271,288400.0,0.0032655649045347,0.0026793669592772,0.0022242088942442,0.011228533685601,0.0033013686200086,0.0031611976035409,1.022884882108183
2855000110,388000.0,3,2.5,2198,6222,2.0,0,2,3,8,2198,0,98198,47.3906,-122.304,2198,7621,4024,5423,10,0,1399,275,266750.0,0.0045684973218795,0.0021438967511453,0.0054085843436493,0.0,0.0046579638891243,0.0029164750031189,1.4545454545454546
191100435,1600000.0,5,3.75,3570,10125,2.0,0,0,3,10,3570,0,98040,47.5639,-122.223,1760,10125,6555,8365,6,-1810,0,282,993750.0,0.0040747517197849,0.0026198947953752,0.0051163650590961,0.0,0.0021530474184227,0.0028047386648391,1.610062893081761
7212650950,336000.0,4,2.5,2530,8169,2.0,0,0,3,8,2530,0,98003,47.2634,-122.312,2220,8013,5639,5793,27,-310,-156,276,269500.0,0.0047460310611787,0.0027856416523843,0.0055108539863295,0.0,0.004277497856434,0.0029711296521928,1.2467532467532467
745530040,845950.0,5,2.75,4450,9600,2.0,0,0,3,9,3650,800,98011,47.7336,-122.21,4000,9750,5150,5750,6,-450,150,194,470000.0,0.0101666879900572,0.0043656584572581,0.0096020035303804,0.0138949196699956,0.0091630682534046,0.005280811912645,1.7998936170212767
2568200290,762500.0,4,2.5,3150,5979,2.0,0,0,3,9,3150,0,98052,47.7082,-122.101,3150,6595,2829,3445,15,0,616,571,615000.0,0.00233054013782,0.0009418788742822,0.0026214872071424,0.0,0.0023624013697428,0.0011492634432455,1.2398373983739837
3905040590,560000.0,3,2.5,2180,7169,2.0,0,0,3,8,2180,0,98029,47.5714,-122.002,2150,5914,4989,3764,30,-30,-1255,320,574500.0,0.0029861377458769,0.0025779479548663,0.0031403053874963,0.0,0.0030374524956557,0.002621021710959,0.9747606614447344
6206100075,700000.0,4,1.75,1980,10800,1.0,0,0,4,8,1320,660,98005,47.5899,-122.173,2310,10800,8820,8490,67,330,0,168,765475.0,0.0044360503021219,0.0032257717658949,0.0036372353704606,0.007910823444804,0.0053546468367018,0.0034999186592978,0.9144648747509716
9829201058,783500.0,3,2.5,2850,7130,2.0,0,0,3,10,1990,860,98122,47.603,-122.289,2280,6459,4280,4179,40,-570,-671,289,574000.0,0.00551295641476,0.0070405776236026,0.0046046268401153,0.0101427055077249,0.0046088724838184,0.0062820045225764,1.3649825783972125
9285800790,590000.0,5,1.0,1840,6710,1.5,0,0,3,7,1840,0,98126,47.5686,-122.378,1410,4880,4870,3470,100,-430,-1830,352,396587.5,0.0033833293799865,0.0037375202472222,0.004185975616692,0.0,0.0028363715365087,0.00276340861923,1.4876918712768306
2026079055,380000.0,1,1.5,1200,44866,1.5,0,0,3,7,1200,0,98019,47.7205,-121.93,1480,67082,43666,65602,37,280,22216,190,401250.0,0.0029084140418229,0.0059273699670497,0.0031016888695894,0.0,0.0037027122367133,0.0095379913685742,0.9470404984423676
7420200050,623000.0,3,2.5,1850,7777,2.0,0,0,5,8,1850,0,98033,47.6908,-122.169,1850,8482,5927,6632,31,0,705,431,678000.0,0.0018039822176109,0.0017171420767814,0.0020855339474197,0.0,0.0019446622699779,0.0019819530579488,0.9188790560471976
5072400100,571000.0,4,2.25,2290,9900,1.0,0,2,4,8,1550,740,98166,47.4434,-122.343,2320,9900,7610,7580,61,30,0,250,392500.0,0.0044114134245667,0.0028985770329052,0.0036176072445502,0.0081634454152325,0.0049097411804541,0.003111683996232,1.4547770700636942
5561710110,319990.0,3,2.25,1840,7326,1.0,0,0,5,7,1370,470,98031,47.3958,-122.168,2050,7475,5486,5425,41,210,149,271,288400.0,0.0035138242247625,0.0022270299913393,0.0029584137719559,0.0077608982826948,0.0039577810941623,0.003249443356225,1.1095353675450763
9103000455,920000.0,4,3.25,2190,4265,2.0,0,0,3,9,1540,650,98122,47.6178,-122.29,1730,4265,2075,2535,5,-460,0,289,574000.0,0.0042362717713419,0.0042115096163625,0.0035633795647123,0.0076659983488618,0.0034970830688622,0.0041481265348797,1.602787456445993
6751500285,555700.0,3,2.0,1810,12420,1.0,0,0,4,7,1810,0,98008,47.5888,-122.127,2230,12330,10610,10100,63,420,-90,283,545000.0,0.0029978551257525,0.0043075179367197,0.0037334675456473,0.0,0.003898737718102,0.0045886172520099,1.0196330275229355
705700210,320000.0,3,2.25,1650,7047,2.0,0,0,3,7,1650,0,98038,47.3826,-122.027,2010,7763,5397,5753,26,360,716,586,342750.0,0.0013089399807387,0.0004730696048046,0.0013683725157818,0.0,0.0016178898369955,0.0006619784414863,0.9336250911743252
1774000200,400000.0,3,1.75,1920,9102,1.0,0,0,3,7,1920,0,98072,47.7487,-122.082,1920,9760,7182,7840,52,0,658,272,517500.0,0.002979067396745,0.0010866120017978,0.0033895253075729,0.0,0.0029956936903201,0.0014958101988508,0.7729468599033816
3500100189,300000.0,2,1.0,960,8153,1.0,0,0,3,6,960,0,98155,47.7341,-122.3,1160,8199,7193,7039,73,200,46,442,377225.0,0.0012188309379919,0.001790196363879,0.0014739072359633,0.0,0.0015266713431944,0.0018874635266492,0.7952813307707601
2568200740,720000.0,5,2.75,2860,5379,2.0,0,0,3,9,2860,0,98052,47.7082,-122.104,2980,6018,2519,3038,15,120,639,571,615000.0,0.0021159824743381,0.0008473601713939,0.0023801439404531,0.0,0.0022349066926455,0.0010487137833891,1.170731707317073
1061500510,350000.0,4,1.75,2420,8400,1.0,0,0,5,7,1620,800,98056,47.5017,-122.165,1660,8400,5980,6740,56,-760,0,404,380000.0,0.0029706336901776,0.0021707782239933,0.0022430341328873,0.0086575401763973,0.0021521686989103,0.0026546398838784,0.9210526315789472
3216000090,785000.0,4,2.5,3230,21781,2.0,0,0,3,9,3230,0,98053,47.6318,-122.01,3230,21780,18551,18550,27,0,-1,400,635000.0,0.0030818669816595,0.0015452256422466,0.0031753022435525,0.0,0.0032638955553422,0.001874626882115,1.236220472440945
7461420060,265000.0,3,1.75,2050,10519,1.0,0,0,3,7,1240,810,98058,47.4257,-122.146,1770,9605,8469,7835,41,-280,-914,451,335000.0,0.0022120742566351,0.0011915805246873,0.0015198276221316,0.0073071718538565,0.001982573514834,0.001543687315326,0.7910447761194029
1843100340,348000.0,3,2.25,2570,8491,2.0,0,0,4,8,2570,0,98042,47.3759,-122.125,2400,8049,5921,5649,31,-170,-442,546,292000.0,0.0023735243974295,0.0008185125147295,0.002547813638833,0.0,0.0022459565763012,0.0010007634100307,1.1917808219178083
8563000130,445000.0,3,1.75,1490,10844,1.0,0,0,3,7,1210,280,98008,47.6208,-122.106,2090,9944,9354,7854,46,600,-900,283,545000.0,0.0024678475897079,0.0037609278990167,0.002495853994604,0.0023537125612595,0.0036539739151718,0.0037006658519048,0.8165137614678899
1139000062,288000.0,3,2.5,1150,887,3.0,0,0,3,7,1150,0,98133,47.7072,-122.356,1180,915,-263,-265,13,30,28,484,375000.0,0.0014728521333302,0.0002582434091157,0.0017399092826429,0.0,0.0015725344858145,0.0002811765656694,0.768
2110900050,468000.0,4,2.5,2150,8165,1.0,0,0,3,8,1430,720,98177,47.773,-122.371,2360,7980,6015,5620,63,210,-185,254,557000.0,0.003639872689104,0.0026965385230168,0.0030614953799251,0.0058258083309059,0.0042499549792904,0.0026842404810374,0.8402154398563735
1725079061,500000.0,3,1.75,1640,47044,1.0,0,0,3,7,1640,0,98014,47.654,-121.94,2280,200811,45404,198531,31,640,153767,123,415000.0,0.0062934594071868,0.0039222375796782,0.0067235710361678,0.0,0.0096288663276855,0.0208144082543265,1.2048192771084338
1592000130,577500.0,3,2.5,2280,10879,2.0,0,0,3,9,2280,0,98074,47.6217,-122.034,2400,9536,8599,7136,36,120,-1343,435,645000.0,0.0019765432858645,0.0017141918032355,0.0021426779150992,0.0,0.0021303016773462,0.0016590239525062,0.8953488372093024
148000680,530000.0,3,1.75,1660,4800,1.0,0,0,3,7,960,700,98116,47.5734,-122.412,1510,4800,3140,3290,79,-150,0,329,565500.0,0.002720009438105,0.0029300290744343,0.0020549616621214,0.0048906588416125,0.002708379295068,0.0029611296215984,0.9372236958443856
7708210040,561000.0,5,2.75,3370,10315,2.0,0,0,3,9,3370,0,98059,47.4893,-122.146,3010,8296,6945,5286,14,-360,-2019,465,435000.0,0.0030067540439503,0.0015386325040032,0.0031848337649082,0.0,0.0027514138702338,0.001416391660294,1.289655172413793
7549801385,280000.0,1,0.75,420,6720,1.0,0,0,3,5,420,0,98108,47.552,-122.311,1420,6720,6300,5300,98,1000,0,185,345000.0,0.0013310937153361,0.0069622082632709,0.0017476697736351,0.0,0.0048849289621246,0.0071820730327051,0.8115942028985508
1311400350,235000.0,4,1.5,2070,7245,1.0,0,0,4,7,1060,1010,98001,47.3417,-122.281,1450,7350,5175,5900,56,-620,105,358,260000.0,0.0030300546288109,0.0013521914740454,0.0017147497597732,0.0155408524388367,0.0022105141198495,0.0018330452418011,0.903846153846154
3142600130,667500.0,3,2.0,1880,3800,1.0,0,0,5,7,1030,850,98115,47.6841,-122.309,1700,3800,1920,2100,93,-180,0,576,570000.0,0.0017801226580261,0.0012103664703006,0.0012697473449336,0.0034704926466385,0.0017447153086452,0.0012481765946523,1.1710526315789471
2344300170,1500000.0,5,3.5,4370,12240,2.0,0,0,3,11,3270,1100,98004,47.582,-122.199,2980,12800,7870,9820,30,-1390,560,315,1150000.0,0.0047661635110374,0.0029697363485538,0.004292408868353,0.0070935706455149,0.0035396968689124,0.0031749559474862,1.3043478260869563
1775910270,355000.0,3,1.0,1200,16000,1.0,0,0,3,7,1200,0,98072,47.7452,-122.101,1960,15500,14800,13540,50,760,-500,272,517500.0,0.0018619171229656,0.0019101067928769,0.002118453317233,0.0,0.0030581039755351,0.0023755182461257,0.6859903381642513
1492800296,575000.0,3,1.75,1530,6743,1.0,0,0,3,7,1410,120,98116,47.5745,-122.396,2040,6000,5213,3960,65,510,-743,329,565500.0,0.0025069966507835,0.0041160804268564,0.0030182249412409,0.0008383986585621,0.0036590024913502,0.003701412026998,1.0167992926613616
623049273,225000.0,3,1.75,1550,9060,2.0,0,0,3,7,1550,0,98146,47.5093,-122.345,1080,7620,7510,6540,72,-470,-1440,281,312000.0,0.0033906610257733,0.0035781835071016,0.0040020862488316,0.0,0.0024980455106883,0.0032807240669956,0.7211538461538461
3303850360,1280000.0,4,3.5,4660,17398,2.0,0,2,3,11,4660,0,98006,47.5422,-122.112,5080,24913,12738,19833,17,420,7515,490,760184.5,0.0032966154512224,0.0026438395029253,0.0041344274483396,0.0,0.0037246542047166,0.0041700820340988,1.6838017612829517
705700140,335000.0,3,2.5,1700,6698,2.0,0,0,3,7,1700,0,98038,47.3826,-122.028,2190,7346,4998,5156,23,490,648,586,342750.0,0.0013486048286399,0.0004496410122011,0.0014098383495934,0.0,0.0017627754940399,0.000626419377967,0.977388767323122
3380900125,360000.0,3,1.0,1570,9467,1.0,0,0,3,7,1570,0,98177,47.7683,-122.359,1570,9100,7897,7530,66,0,-367,254,557000.0,0.0026579535450667,0.0031265315612248,0.0033612222003374,0.0,0.0028273005582567,0.0030609759871479,0.6463195691202872
1762600280,1202500.0,3,2.5,3430,28718,1.5,0,0,3,10,3430,0,98033,47.6477,-122.183,3440,35021,25288,31581,36,10,6303,431,678000.0,0.003344680544003,0.0063408623069319,0.0038666926700809,0.0,0.0036160206533644,0.0081832089179942,1.7735988200589972
807800020,315000.0,5,3.0,2110,10766,2.0,0,0,3,7,2110,0,98030,47.3599,-122.176,1460,10400,8656,8940,15,-650,-366,253,283000.0,0.0042332076077361,0.0036054512440246,0.0046081942867126,0.0,0.0029981928700509,0.0047931590559135,1.1130742049469964
789000550,415000.0,3,1.75,1480,2200,2.0,0,0,3,7,1480,0,98103,47.6969,-122.35,1360,2190,720,830,25,-120,-10,599,550000.0,0.0014964459408903,0.0010555765871193,0.0017584987173652,0.0,0.0014900190634791,0.0010532005755572,0.7545454545454545
9201000460,705000.0,4,2.25,2620,10536,1.0,0,0,3,8,1520,1100,98075,47.5847,-122.075,2760,12431,7916,9671,41,140,1895,358,739999.5,0.002423553984665,0.0015474871912975,0.0014972758445079,0.0166970248937462,0.0025847125490603,0.0023062840163441,0.95270334642118
2768000295,625000.0,3,1.75,2100,3264,1.5,0,0,5,7,1350,750,98107,47.6702,-122.364,1720,3750,1164,2030,108,-380,486,264,529975.0,0.0050300606002538,0.0038669412068552,0.0038791988735955,0.0107944732297063,0.0042839352428393,0.0041231355181187,1.179300910420303
9264902050,315000.0,6,2.75,2940,7350,1.0,0,0,3,8,1780,1160,98023,47.3103,-122.339,2120,8236,4410,6116,42,-820,886,492,269000.0,0.0029898558462359,0.0014231264830284,0.0021118046319705,0.0082595198086069,0.0021860357684946,0.0017167653938784,1.171003717472119
2325400330,350000.0,4,2.25,2190,3850,2.0,0,0,3,7,2190,0,98059,47.4854,-122.16,1900,3850,1660,1950,14,-290,0,465,435000.0,0.0019539440226264,0.0005742835812324,0.0020696694199255,0.0,0.0017367728748984,0.0006573177304884,0.8045977011494253
2380000040,390000.0,4,1.75,1910,77574,1.0,0,0,4,8,1910,0,98042,47.3932,-122.12,2130,37026,75664,34896,49,220,-40548,546,292000.0,0.0017639811669612,0.0074779519276446,0.0018935113035685,0.0,0.0019932864614673,0.0046035862864702,1.3356164383561644
3579000410,500000.0,3,2.25,2010,7447,2.0,0,0,3,8,2010,0,98028,47.747,-122.248,2230,7846,5437,5616,35,220,399,282,442500.0,0.0033557551200308,0.0022189122115853,0.0040000716430742,0.0,0.0037816608104624,0.0027518228283449,1.1299435028248588
3450300270,268000.0,5,1.75,1730,10368,1.0,0,0,5,7,1010,720,98059,47.5008,-122.162,1730,7728,8638,5998,57,0,-2640,465,435000.0,0.0015435265566866,0.0015465382260305,0.0009545050749428,0.0114887505983724,0.0015813774071443,0.0013194159535622,0.6160919540229886
5151600340,290000.0,3,1.5,1950,15954,1.0,0,0,4,8,1950,0,98003,47.336,-122.319,1940,12667,14004,10727,61,-10,-3287,276,269500.0,0.0036580081301575,0.0054403387100184,0.0042474961554714,0.0,0.0037379936222892,0.0046967801453046,1.0760667903525047
8151600900,445000.0,5,3.0,2420,11250,2.0,0,0,3,8,2420,0,98146,47.5082,-122.362,1510,9950,8830,8440,7,-910,-1300,281,312000.0,0.0052938062466913,0.0044431086594805,0.0062484185304339,0.0,0.0034926377047587,0.0042838851006045,1.426282051282051
1328330190,320000.0,3,1.75,2000,9760,1.0,0,0,4,8,1400,600,98058,47.4417,-122.134,1890,8089,7760,6199,42,-110,-1671,451,335000.0,0.0021581212259855,0.0011056018557799,0.0017159344120841,0.0054127198917456,0.0021169852785515,0.0013000402596223,0.9552238805970148
513000550,650000.0,3,2.0,2520,5980,1.0,0,0,3,8,1790,730,98116,47.5767,-122.383,1590,5750,3460,4160,63,-930,-230,329,565500.0,0.0041291709542317,0.0036503278885661,0.0038316472658306,0.005100258506253,0.0028518695888464,0.0035471865258731,1.1494252873563218
868000305,554000.0,4,1.0,1120,7104,1.5,0,0,3,7,1120,0,98177,47.7055,-122.372,1370,7104,5984,5734,74,250,0,254,557000.0,0.001896119726417,0.00234613713013,0.002397814563298,0.0,0.0024671348820457,0.0023895794959009,0.9946140035906644
1951100110,240000.0,3,1.75,1630,9450,1.0,0,0,4,7,1080,550,98032,47.3729,-122.295,1280,9100,7820,7820,43,-350,-350,123,250000.0,0.0075917766620401,0.0073903471899084,0.0061106710422088,0.014486645946373,0.0062302566573699,0.0079621247848695,0.96
5083100065,230000.0,3,1.0,1190,9083,1.0,0,0,3,7,1190,0,98198,47.4116,-122.293,1190,9450,7893,8260,65,0,367,275,266750.0,0.0024733902698073,0.0031297033414743,0.0029282144535681,0.0,0.0025218275832838,0.0036164136962962,0.8622305529522024
9492500170,879950.0,4,2.75,3020,7203,2.0,0,0,3,9,3020,0,98033,47.6948,-122.178,3010,7215,4183,4205,6,-10,12,431,678000.0,0.0029448790795595,0.001590404317739,0.0034044932547068,0.0,0.0031640180716939,0.0016858985278355,1.297861356932153
1724079048,475000.0,3,2.5,2680,87117,1.0,0,0,3,7,1340,1340,98024,47.5646,-121.935,2580,87117,84437,84537,31,-100,0,79,465000.0,0.0142746810833843,0.0106264412576762,0.0076632734759235,0.1039968956150562,0.0152811011869506,0.0137819127049026,1.021505376344086
5104510240,339000.0,4,2.5,1830,8601,2.0,0,0,3,7,1830,0,98038,47.3576,-122.016,1830,5184,6771,3354,17,0,-3417,586,342750.0,0.0014517334331829,0.0005773906159961,0.0015176495175035,0.0,0.0014730041799512,0.0004420579982822,0.9890590809628008
1123049027,157500.0,3,1.0,1100,27008,1.0,0,0,3,6,960,140,98178,47.4963,-122.249,1280,8890,25908,7610,85,180,-18118,258,279500.0,0.0024549187645063,0.0125994713521572,0.0027982627452123,0.0013332063612989,0.0030058943709931,0.004237076083874,0.5635062611806798
6671900130,370000.0,4,2.75,2200,5207,1.0,0,0,5,7,1120,1080,98133,47.74,-122.343,1210,6008,3007,4798,69,-990,801,484,375000.0,0.00281763016811,0.0015159790656887,0.0016945203448348,0.0090117152297987,0.0016125141761318,0.001846239132833,0.9866666666666668
8669400100,910000.0,4,2.75,4190,38912,1.0,0,0,4,9,2040,2150,98005,47.6472,-122.157,3050,36884,34722,33834,55,-1140,-2028,168,765475.0,0.0093873993767125,0.0116223361994912,0.0056211819361665,0.0257701066762555,0.0070699882475933,0.0119528703545871,1.188804337176263
621069146,311000.0,2,1.75,1180,55321,1.0,0,0,3,8,1180,0,98042,47.3329,-122.091,1480,56192,54141,54712,79,300,871,546,292000.0,0.0010897894120493,0.005332814842463,0.0011698132660789,0.0,0.0013850065553857,0.0069865694541493,1.0650684931506849
1980200015,695000.0,4,3.5,3530,7202,2.0,0,0,3,9,2660,870,98177,47.7339,-122.36,2810,8100,3672,5290,20,-720,898,254,557000.0,0.0059761630662964,0.002378502197522,0.0056948095878328,0.0070395183998446,0.0050603277507653,0.0027246049995492,1.2477558348294435
7614100080,140000.0,3,1.75,1270,8991,2.0,0,0,3,7,1270,0,98042,47.3563,-122.149,1270,8993,7721,7723,39,0,2,546,292000.0,0.0011729089434768,0.0008667113437679,0.0012590363117968,0.0,0.0011884853549593,0.0011181345939131,0.4794520547945205
8682250350,507000.0,2,1.75,1670,6460,1.0,0,0,3,8,1670,0,98053,47.7123,-122.027,2170,6254,4790,4084,16,500,-206,400,635000.0,0.0015934111019725,0.000458296572651,0.0016417197358305,0.0,0.0021927719365611,0.0005382881781794,0.7984251968503937
8562790760,785000.0,4,3.5,3070,4684,2.0,0,0,3,10,2190,880,98027,47.5316,-122.076,2290,2664,1614,374,11,-780,-2020,411,571000.0,0.0029688253992199,0.0003460946755137,0.0025199380026211,0.0053330101205987,0.0023441522613903,0.0002274517725827,1.3747810858143608
7424110130,423000.0,4,1.75,1880,7303,1.0,0,0,3,7,1010,870,98034,47.7129,-122.203,1710,7200,5423,5490,44,-170,-103,543,446000.0,0.0017506807168106,0.0013765337098082,0.0011191383742576,0.005076201367657,0.0016460588441971,0.0015615999111623,0.9484304932735426
3295730040,587000.0,3,2.5,2150,5193,2.0,0,0,3,8,2150,0,98033,47.6952,-122.187,2150,7172,3043,5022,25,0,1979,431,678000.0,0.0020965198745208,0.0011466013636011,0.0024237286415959,0.0,0.0022600129083527,0.0016758508997417,0.8657817109144543
5422420140,280000.0,3,2.5,1860,6607,2.0,0,0,3,7,1860,0,98023,47.2891,-122.351,1760,6766,4747,5006,31,-100,159,492,269000.0,0.0018915414537411,0.0012792648535196,0.0022067171996996,0.0,0.0018148221474295,0.0014103490353304,1.0408921933085502
1861100267,580000.0,3,2.75,1430,1521,2.0,0,0,3,9,1130,300,98119,47.6353,-122.371,1930,2700,91,770,11,500,1179,184,744975.0,0.0038749922093688,0.0022865303668069,0.0038625479827586,0.0039225941422594,0.0056228877753175,0.0039366691987711,0.7785496157589181
2436200715,484000.0,2,1.75,1660,6000,1.0,0,0,3,7,1160,500,98105,47.6624,-122.291,1660,4000,4340,2340,78,0,-2000,229,675000.0,0.0033706815680573,0.0051161930066757,0.0029912171675236,0.0047764615972487,0.0035733120943698,0.0035365837485135,0.717037037037037
5420300210,258000.0,3,1.75,2090,7461,1.0,0,0,3,6,1200,890,98030,47.3764,-122.184,1420,7462,5371,6042,34,-670,1,253,283000.0,0.0041930824171414,0.0024986319646728,0.0026207740019219,0.0219428007889546,0.0029160505996385,0.0034390916226179,0.911660777385159
6453550090,861111.0,4,2.5,3650,7090,2.0,0,0,3,10,3650,0,98074,47.606,-122.052,3860,7272,3440,3412,12,210,182,435,645000.0,0.003164203067283,0.0011171633316426,0.0034301642061895,0.0,0.0034262351977319,0.0012651449436478,1.3350558139534885
1300300730,698000.0,3,1.5,1090,7200,1.0,0,0,4,7,1090,0,98040,47.5817,-122.241,2010,8982,6110,6972,62,920,1782,282,993750.0,0.0012441118696262,0.0018630362989334,0.0015621394718248,0.0,0.0024588780176305,0.0024881148333417,0.7023899371069182
5104510540,295000.0,3,2.5,1690,4102,2.0,0,0,3,7,1690,0,98038,47.3552,-122.015,1830,4733,2412,2903,17,140,631,586,342750.0,0.0013406718590596,0.0002753698763883,0.0014015451828311,0.0,0.0014730041799512,0.0004035996346199,0.8606856309263311
2309710150,325000.0,4,3.25,2800,5291,2.0,0,0,3,7,2800,0,98022,47.1937,-121.977,2380,5291,2491,2911,9,-420,0,233,280000.0,0.0065406195835494,0.0003059000022085,0.0069550702462094,0.0,0.0056699066133028,0.0004410342022815,1.1607142857142858
826069127,483000.0,3,2.25,2100,43560,1.0,0,0,4,8,1330,770,98077,47.7511,-122.072,2100,43560,41460,41460,43,0,0,196,652475.0,0.0037523787400941,0.0040358647173699,0.002537078544518,0.0217391304347826,0.0038527868491542,0.0048706662559324,0.7402582474424307
3438501150,300000.0,3,2.0,720,7598,1.0,0,0,5,6,720,0,98106,47.5483,-122.36,1080,7209,6878,6129,73,360,-389,330,315000.0,0.0014630845479983,0.0041601123087966,0.0018310314047316,0.0,0.0024007362257759,0.0042846291825505,0.9523809523809524
3226049080,397000.0,2,1.0,1030,12350,1.5,0,0,3,7,1030,0,98115,47.6984,-122.324,1790,6900,11320,5110,78,760,-5450,576,570000.0,0.0009752799668972,0.003933691028477,0.0012697473449336,0.0,0.0018370825896911,0.0022664259218687,0.6964912280701754
2770600930,601000.0,3,2.5,1740,1251,2.0,0,0,3,9,1180,560,98199,47.644,-122.385,1740,1625,-489,-115,8,0,374,316,689900.0,0.0025465774876695,0.0007277690127473,0.0023463442763118,0.0031049013084941,0.0027637472600781,0.0009735529109531,0.8711407450355124
5592200010,445000.0,3,2.5,2380,5269,2.0,0,0,3,8,2380,0,98056,47.5066,-122.192,2150,7600,2889,5450,12,-230,2331,404,380000.0,0.0029215323068689,0.0013616464835977,0.003295321750785,0.0,0.0027874474112392,0.0024018170377948,1.1710526315789471
3629890190,1300000.0,4,4.0,4270,6002,2.0,0,3,3,10,3180,1090,98029,47.5443,-121.994,4280,5942,1732,1662,16,10,-60,320,574500.0,0.0058489945756396,0.002158298734148,0.0045808124459809,0.0304129464285714,0.0060466496192588,0.0026334310122621,2.2628372497824194
3731800055,450000.0,4,1.0,2000,4676,1.5,0,0,3,7,1250,750,98118,47.5529,-122.268,1140,4676,2676,3536,104,-860,0,498,370000.0,0.0023674046261453,0.0016224607413771,0.001881779109241,0.0041541580352494,0.0014194163708511,0.0016892868290539,1.2162162162162162
1193000450,825000.0,5,1.75,2330,6000,1.5,0,0,3,8,2080,250,98199,47.6461,-122.392,2150,6000,3670,3850,83,-180,0,316,689900.0,0.0034100721530288,0.0034904988620973,0.0041359288938378,0.0013861166555777,0.0034149750627402,0.0035946569019808,1.1958254819539065
4123820450,375000.0,3,2.5,1830,13042,2.0,0,0,3,8,1830,0,98038,47.3738,-122.042,1940,6996,11212,5056,30,110,-6046,586,342750.0,0.0014517334331829,0.0008755177786096,0.0015176495175035,0.0,0.0015615454148116,0.0005965736412003,1.0940919037199124
5315100667,571500.0,3,1.0,1300,6710,1.0,0,0,4,6,1300,0,98040,47.5851,-122.242,1630,9946,5410,8316,68,330,3236,282,993750.0,0.0014838031472606,0.0017362463285894,0.0018631021223599,0.0,0.0019940155068347,0.002755153655357,0.5750943396226416
9407111220,303000.0,2,1.0,1020,9200,1.0,0,0,3,7,1020,0,98045,47.4461,-121.769,1520,9600,8180,8080,42,500,400,218,404750.0,0.0022600622624995,0.0008341788461311,0.0024058589742077,0.0,0.0036383220633115,0.0013571112417016,0.7486102532427424
9376301112,457000.0,2,2.5,1380,1329,2.0,0,0,3,8,1050,330,98117,47.6903,-122.37,1360,3750,-51,2390,12,-20,2421,548,545000.0,0.0014872324328751,0.0005231165148552,0.0014355087442989,0.0016798167472639,0.0016114125927154,0.0014741927811727,0.8385321100917431
4045900020,650000.0,2,1.5,1440,136778,1.0,0,0,4,8,1140,300,98072,47.7608,-122.118,1740,21600,135338,19860,64,300,-115178,272,517500.0,0.0022343005475587,0.0163287866822579,0.0020125306513714,0.0038438869384721,0.0027148474068526,0.0033103996204075,1.2560386473429952
3222049024,361000.0,3,1.0,1100,4046,1.5,0,4,4,6,1100,0,98198,47.344,-122.331,2550,7847,2946,5297,98,1450,3801,275,266750.0,0.002286327140158,0.0013941186523841,0.0027067528562394,0.0,0.005403916249894,0.003002962780406,1.353327085285848
923049468,218000.0,3,1.0,980,12812,1.0,0,0,3,7,980,0,98168,47.4892,-122.306,1430,8986,11832,7556,64,450,-3826,264,237000.0,0.00251559411659,0.0042753852668728,0.0029939205083554,0.0,0.0036682468345338,0.0034834169428345,0.919831223628692
2313900560,554000.0,3,2.0,1830,3500,1.5,0,0,5,7,1290,540,98116,47.573,-122.383,1530,4000,1670,2470,111,-300,500,329,565500.0,0.0029985646215254,0.0021364795334417,0.0027613547334757,0.0037727939635296,0.0027442518685126,0.0024676080179987,0.9796640141467728
3629960060,362000.0,3,2.75,1420,955,2.0,0,0,3,8,1160,260,98029,47.5477,-122.003,1420,955,-465,-465,16,0,0,320,574500.0,0.0019450988986904,0.000343414743604,0.0016709881878421,0.0072544642857142,0.0020061314157354,0.0004232458123039,0.6301131418624891
6381500090,295000.0,4,1.0,1260,7800,1.5,0,0,3,7,1260,0,98125,47.7334,-122.307,1639,7492,6540,5853,73,379,-308,402,425000.0,0.0017891424611784,0.0025220656493688,0.0022015924852309,0.0,0.0024566894198975,0.0025453314978317,0.6941176470588235
2787460430,299950.0,2,1.75,1460,10506,1.0,0,0,3,7,1460,0,98031,47.4048,-122.178,1460,8153,9046,6693,37,0,-2353,271,288400.0,0.0027881431348659,0.0031937178663678,0.0031527621219384,0.0,0.0028187123890132,0.0035441754760271,1.0400485436893203
5706201930,405000.0,3,1.5,1330,12500,1.0,0,0,3,7,1330,0,98027,47.5263,-122.051,2310,12500,11170,10190,54,980,0,411,571000.0,0.0012861686582939,0.0009236087625792,0.0015303733075279,0.0,0.0023646252069047,0.0010672474314129,0.7092819614711033
5126900405,169500.0,2,1.0,790,7450,1.0,0,0,4,6,790,0,98058,47.4743,-122.17,800,7450,6660,6650,76,10,0,451,335000.0,0.0008524578842642,0.0008439276460615,0.0009682772753903,0.0,0.0008960784247837,0.0011973420613408,0.5059701492537313
8155500020,530000.0,5,2.75,2500,7140,1.0,0,0,4,7,1250,1250,98008,47.6225,-122.108,2230,8400,4640,6170,52,-270,1260,283,545000.0,0.0041406838753488,0.0024763025819789,0.0025783615646735,0.0105076453627659,0.003898737718102,0.0031260652811746,0.9724770642201837
2428100130,834538.0,3,2.5,2760,6187,2.0,0,0,3,10,2760,0,98075,47.5821,-122.047,2760,6600,3427,3840,6,0,413,358,739999.5,0.0025530568693417,0.0009087227840316,0.002718737717659,0.0,0.0025847125490603,0.0012244770740786,1.1277548160505513
8029520250,450000.0,3,2.5,3800,13071,2.0,0,0,3,10,2730,1070,98023,47.3076,-122.397,2980,11110,9271,8130,26,-820,-1961,492,269000.0,0.0038644395291485,0.0025308416679816,0.0032388913737526,0.0076186949958702,0.0030728238632614,0.0023158406418151,1.6728624535315986
9545250110,750000.0,3,2.5,2560,9182,2.0,0,0,3,9,2560,0,98027,47.5361,-122.051,2800,8784,6622,5984,27,240,-398,411,571000.0,0.0024756329061899,0.0006784460526402,0.0029456809528357,0.0,0.0028662123720057,0.0007499761150024,1.3134851138353765
1736800740,525000.0,4,1.75,2120,7725,1.0,0,0,3,8,1220,900,98007,47.6003,-122.144,2160,7725,5605,5565,55,40,0,139,560000.0,0.0069620045318708,0.0051942864865846,0.0046437271619975,0.0215362526920315,0.007289908876139,0.005792235330461,0.9375
6181500120,312891.0,5,3.0,2300,8214,2.0,0,0,3,8,2300,0,98001,47.3052,-122.276,2594,4950,5914,2356,7,294,-3264,358,260000.0,0.0033667273653455,0.0015330435842387,0.0037206834410174,0.0,0.0039545335357859,0.0012344998567231,1.203426923076923
1722069097,540000.0,3,2.5,3100,100188,1.0,0,0,4,7,1820,1280,98038,47.3928,-122.066,2430,104979,97088,102549,39,-670,4791,586,342750.0,0.0024592205698728,0.0067256843431481,0.0015093563507412,0.0233789954337899,0.0019559563700991,0.0089519302858164,1.575492341356674
1036700220,470000.0,4,2.0,2410,4680,2.0,0,0,3,9,2410,0,98008,47.6234,-122.113,1910,4611,2270,2701,46,-500,-69,283,545000.0,0.0039916192558362,0.0016231227007929,0.0049710810966906,0.0,0.0033392775971187,0.0017159865489876,0.8623853211009175
4338800170,246000.0,3,1.0,1400,7410,1.0,0,0,3,6,1400,0,98166,47.4798,-122.343,1070,7410,6010,6340,76,-330,0,250,392500.0,0.0026969339713508,0.0021695409912957,0.003267516220884,0.0,0.0022644064927094,0.0023290483244524,0.6267515923566879
1995200338,738000.0,4,2.5,2830,5010,2.0,0,0,3,9,2170,660,98115,47.6952,-122.327,1880,5739,2180,3859,20,-950,729,576,570000.0,0.0026796527245818,0.0015957726358437,0.0026750987752485,0.0026947354668016,0.0019294498707371,0.0018850751254499,1.2947368421052632
3214200070,457500.0,3,1.0,1210,7636,1.0,0,0,4,7,1210,0,98118,47.5377,-122.266,1530,5900,6426,4370,68,320,-1736,498,370000.0,0.0014322797988179,0.0026495103124798,0.0018215621777453,0.0,0.0019050061819318,0.0021314782488063,1.2364864864864864
3426049124,334000.0,2,1.75,1680,8367,1.0,0,0,3,6,840,840,98115,47.6976,-122.288,1830,6720,6687,4890,106,150,-1647,576,570000.0,0.0015907479071722,0.0026650358571066,0.0010355221065478,0.0034296633213839,0.0018781347146004,0.0022073017673852,0.5859649122807018
8698600395,150000.0,2,1.0,1250,5208,1.0,0,0,3,7,1050,200,98002,47.3063,-122.219,1030,5354,3958,4324,69,-220,146,197,235000.0,0.0038989273271137,0.0035205317030369,0.0035039127025178,0.0095529231944975,0.0035363956917773,0.0035818099714003,0.6382978723404256
5561000920,630000.0,4,2.75,2710,37277,2.0,0,0,3,9,2710,0,98027,47.4634,-121.987,2390,39299,34567,36909,20,-320,2022,411,571000.0,0.002620689521787,0.0027543491074134,0.0031182794461659,0.0,0.002446516988962,0.0033553405445676,1.1033274956217165
3679400025,385000.0,3,1.75,2160,5863,1.5,0,0,4,7,1260,900,98144,47.5729,-122.315,1590,3000,3703,1410,92,-570,-2863,340,452500.0,0.003323158723907,0.0042102405862022,0.0025039695867059,0.0061315002418536,0.0026553682695182,0.0022485923811693,0.850828729281768
7852110740,645500.0,4,2.5,2990,8622,2.0,0,0,3,9,2990,0,98065,47.5394,-121.875,2980,8622,5632,5642,20,-10,0,305,500000.0,0.0037965843438511,0.0016397757641826,0.0039777564921243,0.0,0.0038648345448768,0.0024970987373461,1.291
3298400350,312500.0,3,1.0,1170,7350,1.0,0,0,4,7,1170,0,98008,47.625,-122.117,1170,7350,6180,6180,60,0,0,283,545000.0,0.0019378400536632,0.0025491350108607,0.0024133464245344,0.0,0.002045526067345,0.0027353071210278,0.573394495412844
2822049254,375000.0,4,2.5,2790,7956,2.0,0,0,3,9,2790,0,98198,47.3681,-122.31,1660,8192,5166,6532,15,-1130,236,275,266750.0,0.0057989570191282,0.0027413761735956,0.0068653095171891,0.0,0.0035178435195388,0.0031349905820168,1.4058106841611997
3625500130,1256500.0,4,2.5,3150,13700,2.0,0,0,4,9,3150,0,98040,47.5309,-122.224,3200,11900,10550,8700,54,50,-1800,282,993750.0,0.0035953691645161,0.003544944068804,0.004514439758026,0.0,0.0039146316698595,0.0032964335912677,1.2644025157232703
1951700480,524400.0,4,1.75,1990,12950,1.0,0,0,4,8,1850,140,98006,47.5434,-122.166,2090,12850,10960,10760,52,100,-100,490,760184.5,0.0014077821347495,0.0019679113439983,0.001641349952667,0.0004887414906615,0.0015323872613893,0.0021509073230108,0.6898325340756093
925059042,456000.0,4,1.5,2220,12385,1.0,0,0,3,8,1270,950,98033,47.6734,-122.185,2030,8831,10165,6801,42,-190,-3554,431,678000.0,0.0021647786611331,0.0027345769089543,0.0014316908720124,0.0068618811666642,0.0021338726530028,0.0020635024115475,0.672566371681416
3750603940,240000.0,4,1.75,1880,9600,1.0,0,0,5,7,1020,860,98001,47.2633,-122.281,1560,14400,7720,12840,74,-320,4800,358,260000.0,0.0027519336725433,0.0017917236923169,0.0016500422216686,0.0132328050469302,0.0023782082944587,0.0035912723104674,0.9230769230769232
2725069162,772000.0,4,2.5,2990,9643,2.0,0,0,3,9,2990,0,98074,47.6292,-122.024,2990,8666,6653,5676,17,0,-977,435,645000.0,0.0025920458003223,0.0015194366723596,0.0028099153360292,0.0,0.0026540008396939,0.0015076658528124,1.1968992248062016
2742100016,260000.0,3,1.0,940,5650,1.0,0,0,3,6,940,0,98118,47.5551,-122.292,1180,5276,4710,4096,71,240,-374,498,370000.0,0.0011126801742883,0.0019604155664629,0.0014150978901492,0.0,0.0014692204540389,0.0019060473289326,0.7027027027027027
1561600095,1058000.0,4,2.0,2290,11137,1.0,0,0,4,8,2290,0,98004,47.5887,-122.201,2300,10463,8847,8163,65,10,-674,315,1150000.0,0.0024976005584154,0.0027021204014578,0.0030059988711095,0.0,0.0027319808048653,0.0025952784436365,0.92
3438501452,329000.0,4,2.5,1600,6765,1.0,0,0,3,7,830,770,98106,47.5469,-122.365,1600,8942,5165,7342,73,0,2177,330,315000.0,0.0032512989955518,0.0037040220806803,0.0021107723137879,0.0077864293659621,0.0035566462604087,0.0053146281246173,1.0444444444444445
3329520410,245000.0,3,1.75,1920,9306,1.0,0,0,3,7,1000,920,98001,47.3319,-122.267,1860,8458,7386,6598,36,-60,-848,358,260000.0,0.0028104854528101,0.0017368521542397,0.0016176884526162,0.0141560240036928,0.0028355560433931,0.0021093736945787,0.9423076923076924
5200100125,555000.0,3,2.0,1980,3478,1.5,0,0,4,7,1440,540,98117,47.6775,-122.372,1610,3478,1498,1868,91,-370,0,548,545000.0,0.0021338552297774,0.0013689986746927,0.0019686977064671,0.0027487910409773,0.0019076281428469,0.0013672646647783,1.018348623853211
5699000070,1400000.0,4,3.25,2980,7000,2.0,0,3,3,10,2140,840,98144,47.5933,-122.292,2200,4800,4020,2600,120,-780,-2200,340,452500.0,0.0045847282394643,0.0050267242202653,0.0042527737425005,0.0057227335590633,0.0036740944609685,0.003597747809871,3.0939226519337018
739800070,265000.0,3,2.5,1440,7741,1.0,0,0,4,7,1000,440,98031,47.4042,-122.194,1680,7316,6301,5636,37,240,-425,271,288400.0,0.0027499493932924,0.0023531857989295,0.0021594261109167,0.0072655217965653,0.0032434498722891,0.0031803247617582,0.9188626907073508
9477500060,484000.0,6,2.5,3300,13501,1.0,0,0,3,8,2060,1240,98059,47.5116,-122.163,2060,8745,10201,6685,40,-1240,-4756,465,435000.0,0.0029442992121769,0.0020138708130438,0.0019468123310715,0.0197861815860858,0.0018830274327846,0.001493050273538,1.1126436781609197
6669020290,279950.0,3,1.75,1720,9775,1.0,0,0,3,8,1720,0,98032,47.3731,-122.286,1970,8400,8055,6430,42,250,-1375,123,250000.0,0.0080109545145454,0.0076445125694555,0.0097318094375919,0.0,0.0095887543867334,0.0073496536475718,1.1198
1021049057,207000.0,3,1.0,1980,18730,1.0,0,0,4,7,1280,700,98001,47.3221,-122.282,1356,9450,16750,8094,77,-624,-9280,358,260000.0,0.0028983131232105,0.0034957275788643,0.0020706412193488,0.0107708878288967,0.0020672118251833,0.0023567724537442,0.7961538461538461
2112700370,199400.0,2,1.0,880,4000,1.0,0,0,4,6,880,0,98106,47.5331,-122.352,1430,4000,3120,2570,104,550,0,330,315000.0,0.0017882144475534,0.0021901091386136,0.0022379272724498,0.0,0.0031787525952403,0.0023773778235819,0.633015873015873
993002247,430000.0,3,2.25,1550,1469,3.0,0,0,3,8,1550,0,98103,47.6911,-122.341,1520,1465,-81,-55,16,-30,-4,599,550000.0,0.001567223789446,0.0007048372756719,0.0018416709539974,0.0,0.0016653154238885,0.0007045382845622,0.7818181818181819
291310170,384500.0,3,2.5,1600,2610,2.0,0,0,3,8,1600,0,98027,47.5344,-122.068,1445,1288,1010,-157,15,-155,-1322,411,571000.0,0.0015472705663687,0.0001928495096265,0.0018410505955223,0.0,0.00147917031341,0.0001099691753327,0.6733800350262698
2050100450,865000.0,3,2.5,3050,12558,2.0,0,0,3,10,3050,0,98074,47.6549,-122.089,3543,12558,9508,9015,23,493,0,435,645000.0,0.0026440600973187,0.0019787499462296,0.0028663015969528,0.0,0.0031448578511824,0.0021847758804083,1.3410852713178294
3760100100,425000.0,5,2.75,1340,11583,1.0,0,0,3,7,1190,150,98034,47.709,-122.214,1950,10514,10243,8564,58,610,-1069,543,446000.0,0.0012478256173011,0.0021832657758057,0.0013185887775906,0.0008752071323546,0.0018770846468914,0.00228036964805,0.952914798206278
3500100078,352500.0,3,1.75,1170,8182,1.0,0,0,3,7,1170,0,98155,47.7368,-122.298,1610,8183,7012,6573,58,440,1,442,377225.0,0.0014854502056777,0.0017965640438192,0.0017963244438303,0.0,0.0021189145366749,0.001883780221804,0.9344555636556432
7202290320,440500.0,3,2.5,1600,3172,2.0,0,0,3,7,1600,0,98053,47.6868,-122.042,1690,3698,1572,2008,18,90,526,400,635000.0,0.0015266214150635,0.0002250335492955,0.0015729051361251,0.0,0.0017077348261697,0.0003182906432535,0.6937007874015748
9250900095,331000.0,2,1.0,1480,6210,1.0,0,0,3,7,1080,400,98133,47.774,-122.351,1290,7509,4730,6219,70,-190,1299,484,375000.0,0.0018954966585467,0.0018079950063236,0.0016340017610907,0.0033376723073328,0.0017191266836447,0.0023074916192482,0.8826666666666667
8100000110,241250.0,3,1.75,1350,7588,1.0,0,0,3,7,1350,0,98010,47.3123,-122.023,1470,7341,6238,5871,27,120,-247,99,359999.0,0.0064160753579932,0.0014190400085875,0.0068638018344145,0.0,0.0074420582606846,0.0015961714498176,0.6701407503909733
3524039202,1065500.0,3,2.25,2950,7232,1.0,0,2,3,8,1520,1430,98136,47.5257,-122.382,2130,7140,4282,5010,37,-820,-92,263,489950.0,0.006495565400435,0.0045965614771029,0.0042743454908467,0.0145109897915694,0.0048433307562872,0.0047186676174495,2.1747117052760485
3862700020,433190.0,3,2.5,1650,2787,2.0,0,0,3,8,1650,0,98065,47.5336,-121.838,1760,2787,1137,1027,6,110,0,305,500000.0,0.0020951050726937,0.0005300458193895,0.0021950830140485,0.0,0.0022825868452963,0.0008071693552521,0.86638
2436701200,720000.0,3,1.75,2040,4000,2.0,0,0,5,7,1360,680,98105,47.6675,-122.289,1610,4000,1960,2390,96,-430,0,229,675000.0,0.0041422833727933,0.0034107953377838,0.0035069442653725,0.0064959877722583,0.0034656822120093,0.0035365837485135,1.0666666666666669
5104511630,444000.0,4,3.0,2800,7198,2.0,0,0,3,8,2800,0,98038,47.3538,-122.013,3610,7845,4398,4235,18,810,647,586,342750.0,0.0022212314824657,0.0004832063311173,0.002322086693448,0.0,0.0029057623440567,0.0006689708712431,1.2954048140043763
2738640310,680000.0,4,2.5,3490,3677,2.0,0,0,3,9,2850,640,98072,47.774,-122.162,3440,3600,187,160,13,-50,-77,272,517500.0,0.0054150756326251,0.000438966417338,0.0050313266284285,0.0082002921354073,0.0053672845284902,0.0005517332700679,1.3140096618357489
1088030010,464625.0,4,2.75,2040,8996,1.0,0,0,4,8,1260,780,98033,47.666,-122.185,2470,9180,6956,6710,46,430,184,431,678000.0,0.0019892560669872,0.0019862942166292,0.0014204177155399,0.0056339655894717,0.0025963869226192,0.0021450517651462,0.6852876106194691
1962200475,875000.0,3,2.0,2350,6000,1.5,0,0,4,8,1990,360,98102,47.6476,-122.32,2010,5040,3650,3030,98,-340,-960,104,710000.0,0.0105047181829966,0.0160027311327799,0.0109188275703139,0.0086841153057532,0.0098885691092908,0.014669755853349,1.232394366197183
2767601815,356000.0,3,1.0,940,2366,1.0,0,0,3,6,940,0,98107,47.6744,-122.383,1500,5000,1426,3500,104,560,2634,264,529975.0,0.0022515509353517,0.0028030584851163,0.0027010718082813,0.0,0.0037359900373599,0.0054975140241582,0.6717297985754045
6613000750,1600000.0,4,2.75,3680,5000,2.0,0,3,3,9,2480,1200,98105,47.6599,-122.269,3200,5000,1320,1800,84,-480,0,229,675000.0,0.0074723543195487,0.0042634941722298,0.0063950160133263,0.011463507833397,0.0068883124710744,0.0044207296856419,2.3703703703703702
8635750980,570000.0,4,2.5,2640,4200,2.0,0,0,3,8,2640,0,98074,47.6038,-122.02,2460,4200,1560,1740,22,-180,0,435,645000.0,0.0022886290678431,0.0006617892796754,0.0024809954806411,0.0,0.0021835592192799,0.000730694274384,0.8837209302325582
3546000490,290000.0,3,1.75,2060,7251,1.0,0,0,3,7,1350,710,98030,47.3569,-122.175,1520,7582,5191,6062,33,-540,331,253,283000.0,0.0041328946312494,0.0024283045671951,0.0029483707521621,0.0175049309664694,0.0031214062756694,0.0034943973040323,1.0247349823321554
7853230720,368000.0,3,2.5,2080,4307,2.0,0,0,3,7,2080,0,98065,47.53,-121.848,2080,4947,2227,2867,16,0,640,305,500000.0,0.0026411021522443,0.0008191271417692,0.0027671349510429,0.0,0.0026976026353502,0.0014327473270298,0.736
9310300185,227000.0,2,1.0,1040,9100,1.0,0,0,4,7,1040,0,98133,47.7407,-122.347,1950,13228,8060,11278,83,910,4128,484,375000.0,0.0013319706249247,0.0026493968691698,0.0015734831773466,0.0,0.0025986798706257,0.0040649219788807,0.6053333333333333
6132600655,930000.0,3,2.25,2890,5000,3.0,0,0,3,9,2890,0,98117,47.6983,-122.389,2020,5000,2110,2980,6,-870,0,548,545000.0,0.0031145664717458,0.0019680832011109,0.0039510669247848,0.0,0.0023934216450626,0.001965590374897,1.7064220183486238
3343902281,310000.0,2,1.0,1020,8102,1.0,0,0,3,7,1020,0,98056,47.5135,-122.193,1770,7291,7082,5521,64,750,-811,404,380000.0,0.0012520852743723,0.0020937672822373,0.0014122807503364,0.0,0.0022947822873923,0.0023041642134949,0.8157894736842105
4217402162,1185000.0,3,2.25,2390,7875,1.0,0,1,3,10,1980,410,98105,47.6515,-122.278,3720,9075,5485,5355,72,1330,1200,229,675000.0,0.0048529692455764,0.0067150033212619,0.0051056982687041,0.0039166985097439,0.008007663247624,0.00802362437944,1.7555555555555555
8091800140,375000.0,4,2.5,2210,9427,2.0,0,0,3,7,2210,0,98148,47.4323,-122.327,1770,8770,7217,7000,21,-440,-657,56,279000.0,0.0243204577968526,0.0187407682780639,0.0263723150357995,0.0,0.0196187098204389,0.0177630326378002,1.3440860215053765
2331300415,780000.0,3,2.25,2140,3000,2.0,0,0,3,9,2140,0,98103,47.6767,-122.351,1430,4712,860,3282,115,-710,1712,599,550000.0,0.0021637799415577,0.0014394226187991,0.0025426940913254,0.0,0.0015667112211582,0.002266064434715,1.4181818181818182
259000240,506000.0,3,1.75,2180,7700,1.0,0,0,3,8,1480,700,98177,47.7594,-122.361,2180,7604,5520,5424,59,0,-96,254,557000.0,0.0036906616103473,0.0025429695807997,0.0031685406729295,0.005663980321714,0.0039258058707005,0.0025577649897003,0.9084380610412928
1862400528,350500.0,2,2.5,1290,1445,3.0,0,0,3,8,1290,0,98117,47.6955,-122.376,1470,1503,155,33,21,180,58,548,545000.0,0.0013902390133398,0.000568776045121,0.0017636250287101,0.0,0.0017417474347733,0.000590856466694,0.6431192660550459
2050000020,1215000.0,4,3.75,3820,53574,1.0,0,0,3,10,3820,0,98072,47.7337,-122.121,3140,54014,49754,50874,26,-680,440,272,517500.0,0.0059271028414406,0.0063957538325994,0.0067437430598586,0.0,0.0048992073893777,0.0082781446804023,2.347826086956522
7979900145,385000.0,3,1.0,1470,11398,1.0,0,0,3,8,1470,0,98155,47.746,-122.296,1710,11407,9928,9697,70,240,9,442,377225.0,0.0018663348738002,0.002502717791671,0.0022569204550688,0.0,0.0022505241352262,0.0026259661481264,1.020611041155809
7237590010,214100.0,2,2.5,1150,2064,2.0,0,0,3,7,1150,0,98001,47.3516,-122.292,1880,2855,914,975,16,730,791,358,260000.0,0.0016833636826727,0.0003852205938481,0.0018603417205087,0.0,0.0028660458933221,0.0007120196143322,0.8234615384615385
1422300100,435000.0,3,2.5,1730,46638,2.0,0,0,3,8,1730,0,98045,47.4614,-121.709,1750,35508,44908,33758,29,20,-11130,218,404750.0,0.0038332428569845,0.0042287427202028,0.0040805255150778,0.0,0.0041888576386811,0.0050196152052439,1.0747374922791846
1588600045,459000.0,2,1.75,1170,4887,1.0,0,0,3,6,1020,150,98117,47.695,-122.366,1170,5441,3717,4271,91,0,554,548,545000.0,0.0012609144539593,0.0019236045207658,0.0013944942087475,0.0007635530669381,0.0013862887746155,0.0021389554459629,0.8422018348623853
2600140070,1027500.0,4,3.0,3540,10202,2.0,0,0,3,8,2720,820,98006,47.5471,-122.155,2780,10714,6662,7934,32,-760,512,490,760184.5,0.0025042958577956,0.0015503190371792,0.0024132280385158,0.0028626287310176,0.0020382950175418,0.0017933712886177,1.3516455544673691
1136100045,494950.0,2,1.75,2220,33000,1.0,0,0,4,8,2220,0,98072,47.7403,-122.129,2220,33000,30780,30780,50,0,0,272,517500.0,0.0034445466774864,0.0039395952603087,0.0039191386368812,0.0,0.0034637708294326,0.0050575549756225,0.9564251207729468
7137910360,200000.0,3,2.0,1290,5757,1.0,0,0,3,7,1290,0,98092,47.3175,-122.17,1580,6798,4467,5218,26,290,1041,351,309780.0,0.0016738529889953,0.0005047512550394,0.0017798823621936,0.0,0.0021133222227869,0.0006410744853486,0.645619471883272
8854000370,436500.0,5,3.0,3110,12429,1.0,0,0,3,8,1790,1320,98011,47.7463,-122.213,3050,11902,9319,8852,43,-60,-527,194,470000.0,0.0071052583481073,0.0056521634338814,0.0047089277587345,0.0229266174554928,0.006986839543221,0.0064463818855694,0.9287234042553192
2500600289,130000.0,2,1.0,790,7500,1.0,0,0,3,7,790,0,98198,47.4007,-122.294,1560,7794,6710,6234,69,770,294,275,266750.0,0.0016419985824771,0.0025842535573111,0.0019439406876628,0.0,0.0033059252352292,0.0029826802485643,0.4873477038425492
267020090,580000.0,5,2.5,3110,15783,1.0,0,0,3,8,1720,1390,98052,47.6301,-122.103,2550,12220,12673,9670,46,-560,-3563,571,615000.0,0.0023009459773397,0.0024863144794776,0.0014314152369158,0.0092660489300713,0.0019124201564584,0.0021294919297135,0.943089430894309
1126049053,770000.0,4,2.75,3820,26300,2.0,0,0,3,9,2850,970,98028,47.7618,-122.261,1860,12136,22480,10276,6,-1960,-14164,282,442500.0,0.006377604257969,0.0078363624499389,0.0056717433745082,0.0100538971807628,0.0031542103620897,0.0042564519302567,1.7401129943502824
5021900779,785000.0,3,2.0,1600,9638,1.0,0,0,5,7,1600,0,98040,47.5753,-122.224,1800,11400,8038,9600,68,200,1762,282,993750.0,0.0018262192581669,0.0024938810901556,0.0022930487659814,0.0,0.0022019803142959,0.0031579279781892,0.789937106918239
3278600760,345000.0,3,2.5,1360,1489,2.0,0,0,3,8,1360,0,98126,47.549,-122.372,1360,1688,129,328,13,0,199,352,396587.5,0.0025007217156421,0.0008293841502405,0.0030939819775549,0.0,0.0027357909855687,0.0009558675715697,0.869921517950011
2475200930,289000.0,3,1.75,1690,3449,1.0,0,0,3,7,1690,0,98055,47.4719,-122.191,1530,4093,1759,2563,33,-160,644,260,297225.0,0.0036345492943812,0.0013152405452547,0.0040956789375469,0.0,0.003293616196842,0.0020717515436902,0.9723273614265288
7345000340,208000.0,3,1.0,1020,6120,1.0,0,0,4,7,1020,0,98002,47.278,-122.205,1370,8000,5100,6630,53,350,1880,197,235000.0,0.0031815246989248,0.0041370303422784,0.0034038009110173,0.0,0.0047037496094514,0.0053519760499071,0.8851063829787233
3583300135,460000.0,3,2.25,2350,10450,1.0,0,0,3,8,1390,960,98028,47.7433,-122.259,2250,10450,8100,8200,43,-100,0,282,442500.0,0.0039233952895883,0.0031136877415156,0.0027662186984443,0.0099502487562189,0.003815577050915,0.0036651221713235,1.03954802259887
9521100031,690000.0,3,3.25,1540,1428,3.0,0,0,3,9,1540,0,98103,47.6648,-122.353,1660,3300,-112,1640,7,120,1872,599,550000.0,0.0015571126682237,0.0006851651665483,0.0018297892059071,0.0,0.0018186997392466,0.0015870145659082,1.2545454545454546
3121500150,894000.0,4,2.5,3800,22029,2.0,0,0,3,9,3800,0,98053,47.6734,-122.026,3170,24979,18229,21809,27,-630,2950,400,635000.0,0.0036257258607759,0.0015628196902369,0.0037356496982971,0.0,0.0032032659165433,0.0021499680848646,1.4078740157480314
225069017,850000.0,4,3.0,2720,183823,2.0,0,0,3,8,2720,0,98053,47.6749,-122.002,2140,173804,181103,171664,45,-580,-10019,400,635000.0,0.002595256405608,0.0130410914666313,0.0026739387314126,0.0,0.0021624571171617,0.0149594880908689,1.3385826771653544
1771000440,322500.0,3,1.0,1160,9750,1.0,0,0,3,7,1160,0,98077,47.7429,-122.072,1160,10565,8590,9405,52,0,815,196,652475.0,0.0020727425421472,0.0009033443754443,0.0022127903095045,0.0,0.0021282060690566,0.0011813266527531,0.494271811180505
2050100210,805000.0,3,2.5,2690,17461,2.0,0,3,3,10,2690,0,98074,47.654,-122.088,3610,16887,14771,13277,23,920,-574,435,645000.0,0.0023319743153401,0.0027513101458126,0.0025279840314109,0.0,0.0032043287730083,0.0029379129075055,1.248062015503876
7129302615,292000.0,3,1.75,1090,4500,1.5,0,0,5,8,1090,0,98118,47.5157,-122.256,1640,5225,3410,3585,91,550,725,498,370000.0,0.0012902355212492,0.0015613929290412,0.0016409113832581,0.0,0.0020419674106981,0.0018876226864429,0.7891891891891892
2492200435,389250.0,2,1.5,1490,4080,1.0,0,0,3,7,930,560,98126,47.5344,-122.381,1320,4080,2590,2760,64,-170,0,352,396587.5,0.0027397612914021,0.0022725905527073,0.002115737675828,0.0053701572688914,0.0026553265448166,0.0023103908127988,0.9814984082957732
5205000160,350000.0,4,2.5,2650,10459,2.0,0,0,4,8,2650,0,98003,47.2739,-122.293,2340,8777,7809,6437,31,-310,-1682,276,269500.0,0.0049711392538038,0.0035665351992028,0.0057722383651278,0.0,0.0045087139567818,0.0032544121998372,1.2987012987012987
5451220200,998000.0,4,2.25,2420,10200,2.0,0,0,4,9,2420,0,98040,47.5336,-122.225,2390,10200,7780,7810,47,-30,0,282,993750.0,0.0027621566279774,0.0026393014234891,0.0034682362585469,0.0,0.0029237405284263,0.0028255145068009,1.0042767295597483
5412300410,248000.0,3,1.0,1420,8800,1.0,0,0,4,6,1090,330,98030,47.3746,-122.181,1480,8000,7380,6520,39,60,-800,253,283000.0,0.0028488885322205,0.0029470528466856,0.002380536385079,0.0081360946745562,0.0030392640052571,0.0036870454276258,0.8763250883392226
7987400356,255000.0,2,1.0,1220,2500,1.0,0,0,3,6,770,450,98126,47.5727,-122.372,1540,3000,1280,1460,110,320,500,352,396587.5,0.0022432944802084,0.0013925187210216,0.0017517397961156,0.0043153049482163,0.0030978809689527,0.0016988167741168,0.6429854697891386
9149000180,374950.0,3,2.5,2120,9653,2.0,0,0,3,8,2120,0,98030,47.3843,-122.213,1780,9801,7533,8021,28,-340,148,253,283000.0,0.0042532702030334,0.0032327160373927,0.004630034070062,0.0,0.0036553310333497,0.00451709152952,1.3249116607773852
3546000340,192500.0,3,1.75,1420,7205,1.0,0,0,3,7,1420,0,98030,47.3555,-122.175,1690,7405,5785,5715,34,270,200,253,283000.0,0.0028488885322205,0.0024128995182238,0.0031012492356075,0.0,0.0034705109249219,0.0034128214239461,0.6802120141342756
9541600255,762450.0,4,1.75,2570,8640,1.0,0,0,4,8,2570,0,98005,47.5956,-122.172,2520,8800,6070,6280,62,-50,160,168,765475.0,0.0057579036749764,0.0025806174127159,0.0070815870470333,0.0,0.0058414329127656,0.0028517855742426,0.9960482053626832
3904901570,432250.0,3,2.25,1440,6232,2.0,0,0,3,7,1440,0,98029,47.5658,-122.018,1740,5999,4792,4259,35,300,-233,320,574500.0,0.0019724946578269,0.0022410059498851,0.0020743301642178,0.0,0.0024582173685772,0.0026586928042007,0.7523933855526544
3276930420,585000.0,4,2.5,2330,45860,2.0,0,0,3,9,2330,0,98075,47.5842,-121.992,2930,5020,43530,2090,31,600,-40840,358,739999.5,0.0021552980092631,0.0067357405650061,0.0022951662616469,0.0,0.0027439158582416,0.0009313446836173,0.7905410746899153
4443801340,480000.0,3,1.75,1680,2552,1.0,0,0,4,7,840,840,98117,47.6848,-122.391,1220,3880,872,2660,68,-460,1328,548,545000.0,0.0018105438313262,0.001004509665847,0.0011484069954391,0.0042758971748536,0.0014455318846418,0.0015252981309201,0.8807339449541285
2770604665,612125.0,2,1.5,1670,6000,1.0,0,0,3,7,1090,580,98119,47.6517,-122.374,1670,6000,4330,4330,70,0,0,184,744975.0,0.0045253405521999,0.0090198436560432,0.0037258206205371,0.0075836820083682,0.0048654003029949,0.008748153775047,0.8216718681834961
8857320120,542000.0,2,2.25,1800,2819,2.0,0,2,4,9,1800,0,98008,47.6104,-122.113,1800,2755,1019,955,41,0,-64,283,545000.0,0.0029812923902511,0.0009776886524648,0.0037128406531299,0.0,0.0031469631805307,0.0010252749820995,0.9944954128440368
3861500340,279900.0,3,1.75,1580,6620,1.0,0,0,3,7,1580,0,98003,47.2798,-122.303,1580,8137,5040,6557,32,0,1517,276,269500.0,0.0029639245362302,0.0022574302532482,0.0034415609875101,0.0,0.0030443453212458,0.0030171074478837,1.0385899814471242
3744000130,559630.0,4,2.5,3370,4934,2.0,0,0,3,9,3370,0,98038,47.3562,-122.022,2980,5046,1564,2066,6,-390,112,586,342750.0,0.0026734107485391,0.0003312225670648,0.0027947971988999,0.0,0.0023986625444014,0.0004302902506427,1.632764405543399
7972601900,299950.0,3,1.0,1210,9525,1.0,0,0,3,7,1210,0,98106,47.5274,-122.345,1680,7620,8315,5940,65,470,-1905,330,315000.0,0.002458794865386,0.0052151973863237,0.0030771499996185,0.0,0.0037344785734291,0.0045289047539235,0.9522222222222222
6143000020,299000.0,3,1.75,1910,17003,1.5,0,0,4,8,1910,0,98001,47.3095,-122.283,1820,14806,15093,12986,57,-90,-2197,358,260000.0,0.0027958475077434,0.0031734039521318,0.0030897849444971,0.0,0.0027745763435352,0.0036925262381098,1.15
9406500540,243000.0,2,1.5,1068,1758,2.0,0,0,3,7,1068,0,98028,47.7527,-122.244,1078,1315,690,237,30,10,-443,282,442500.0,0.0017830579443746,0.0005238146458932,0.0021254112013946,0.0,0.0018280853603939,0.0004612091536163,0.5491525423728814
3034200550,525000.0,4,2.5,2140,7754,2.0,0,0,3,8,2140,0,98133,47.7173,-122.338,1690,7775,5614,6085,24,-450,21,484,375000.0,0.0027407857089797,0.0022575190465432,0.0032377442303095,0.0,0.0022521892212089,0.0023892325662078,1.4
9310300300,411000.0,5,1.75,2860,12293,1.0,0,0,4,8,1430,1430,98133,47.7385,-122.348,1920,18110,9433,16190,73,-940,5817,484,375000.0,0.003662919218543,0.003579014913484,0.0021635393688516,0.0119321784987149,0.0025587001803084,0.0055651449227041,1.096
3066400710,720000.0,3,2.5,2520,10012,2.0,0,0,3,10,2520,0,98074,47.6295,-122.051,2680,10071,7492,7391,33,160,59,435,645000.0,0.0021846004738502,0.0015775795876454,0.0023682229587938,0.0,0.0023788368730366,0.0017521004850766,1.1162790697674418
3286800260,780000.0,5,2.5,3480,74052,1.0,0,0,4,8,1980,1500,98027,47.4961,-122.063,2610,65775,70572,63165,48,-870,-8277,411,571000.0,0.0033653134818519,0.0054716060869216,0.0022783001119588,0.0090903581601115,0.0026717193896196,0.0056158559840947,1.3660245183887916
6624300110,375000.0,4,2.5,1870,7471,2.0,0,0,3,8,1870,0,98055,47.4314,-122.204,2020,8912,5601,6892,30,150,1441,260,297225.0,0.0040216610535461,0.0028489887253111,0.0045319050965756,0.0,0.0043484344559613,0.0045109821053915,1.2616704516780215
6699930360,337000.0,4,2.5,2610,5240,2.0,0,0,3,8,2610,0,98038,47.345,-122.042,2480,5240,2630,2760,16,-130,0,586,342750.0,0.0020705050604412,0.0003517645422415,0.002164516524964,0.0,0.0019962023859448,0.0004468333161649,0.9832239241429612
7686203620,260000.0,4,2.5,2050,12500,1.0,0,0,3,7,1300,750,98198,47.42,-122.319,1790,7900,10450,6110,55,-260,-4600,275,266750.0,0.0042608823975673,0.0043070892621852,0.003198889739192,0.0100361300682456,0.0037933372891413,0.0030232453122476,0.9746954076850984
8092501240,219950.0,3,1.5,1620,9310,1.0,0,0,4,7,1620,0,98042,47.3665,-122.107,1610,10640,7690,9030,53,-10,1330,546,292000.0,0.0014961515656949,0.0008974621966944,0.0016060148229219,0.0,0.001506662536602,0.001322912496301,0.7532534246575342
3432500765,320000.0,2,1.0,1100,8281,1.0,0,0,4,7,1100,0,98155,47.7414,-122.315,1510,8281,7181,6771,73,410,0,442,377225.0,0.0013965771164491,0.0018183019856841,0.0016888520412079,0.0,0.0019873049381237,0.0019063404639813,0.8483000861554775
2524049250,1180000.0,5,2.25,3270,16553,2.0,0,2,5,9,2470,800,98040,47.5428,-122.236,3690,17916,13283,14226,52,420,1363,282,993750.0,0.0037323356088786,0.0042831722022563,0.0035398940324839,0.0044851597277508,0.0045140596443067,0.0049629331278279,1.1874213836477987
4083801395,780000.0,3,2.75,1970,2600,2.5,0,0,3,8,1970,0,98103,47.663,-122.335,1680,3120,630,1440,96,-290,520,599,550000.0,0.0019918908807797,0.0012474996029592,0.0023407043737902,0.0,0.0018406117842978,0.0015004501350405,1.4181818181818182
7689600330,207000.0,3,1.0,860,7740,1.0,0,0,3,6,860,0,98178,47.4906,-122.244,980,7200,6880,6220,60,120,-540,258,279500.0,0.0019193001249776,0.0036107785939609,0.002506777042586,0.0,0.0023013878777916,0.0034316026776033,0.740608228980322
2202500025,550000.0,4,1.0,2420,15520,2.0,0,0,4,7,2420,0,98006,47.5744,-122.137,1630,9965,13100,8335,75,-790,-5555,490,760184.5,0.0017119762643687,0.0023584543674791,0.0021470631813265,0.0,0.0011951154239543,0.0016679993364827,0.7235085693012683
5423040140,680000.0,3,2.25,2300,9914,2.0,0,0,4,8,2300,0,98027,47.5677,-122.086,2240,9032,7614,6792,40,-60,-882,411,571000.0,0.002224201439155,0.0007325325817768,0.0026465102310633,0.0,0.0022929698976045,0.0007711503040417,1.190893169877408
6190701484,450000.0,7,3.5,2830,8625,1.0,0,0,4,8,1830,1000,98133,47.7493,-122.355,1570,8400,5795,6830,63,-1260,-225,484,375000.0,0.0036244969889779,0.0025111041754494,0.0027687252062927,0.0083441807683321,0.0020922704599396,0.0025812930618837,1.2
2172000890,385000.0,4,2.5,2560,6238,2.0,0,0,3,8,2560,0,98178,47.4899,-122.255,2560,6240,3678,3680,13,0,2,258,279500.0,0.0057132654883056,0.0029100822828331,0.0074620339872329,0.0,0.0060117887419862,0.0029740556539228,1.3774597495527727
7972604355,218000.0,3,1.0,1020,7874,1.0,0,0,3,7,1020,0,98106,47.5175,-122.346,1290,7320,6854,6030,64,270,-554,330,315000.0,0.0020727031096642,0.0043112298393609,0.0025939611567032,0.0,0.0028675460474545,0.0043506014171549,0.692063492063492
2770605548,952000.0,3,3.5,2760,4500,2.0,0,0,3,9,2120,640,98119,47.6529,-122.372,1950,6000,1740,4050,16,-810,1500,184,744975.0,0.0074790059425579,0.0067648827420324,0.0072465501977419,0.00836820083682,0.0056811560424192,0.008748153775047,1.2778952313836034
3438501662,270000.0,3,1.0,1500,5605,1.0,0,0,5,6,750,750,98106,47.5456,-122.359,1050,9100,4105,8050,78,-450,3495,330,315000.0,0.0030480928083298,0.0030688904304823,0.0019073243799288,0.0075841844473657,0.0023340491083932,0.0054085345486488,0.8571428571428571
2354300550,460000.0,3,1.75,1210,7500,1.0,0,0,3,7,1210,0,98027,47.5294,-122.033,1250,6000,6290,4750,69,40,-1500,411,571000.0,0.0011701233658163,0.0005541652575475,0.0013922945128637,0.0,0.0012795590946454,0.0005122787670782,0.8056042031523643
8559300020,499950.0,4,2.5,2798,4473,2.0,0,0,3,9,2798,0,98055,47.4295,-122.205,2358,4593,1675,2235,8,-440,120,260,297225.0,0.0060174372341294,0.0017057323742894,0.0067808932942345,0.0,0.0050760437857212,0.0023248362668383,1.6820590461771383
4218400005,1285000.0,3,2.25,2440,9200,1.0,0,1,4,8,2440,0,98105,47.6629,-122.269,2750,6211,6760,3461,70,310,-2989,229,675000.0,0.0049544957988312,0.0078448292769028,0.0062918705937566,0.0,0.0059196435298296,0.0054914304155043,1.903703703703704
8824900050,656500.0,4,2.0,2710,4750,1.0,0,0,4,7,1460,1250,98115,47.6756,-122.305,1700,3800,2040,2100,101,-1010,-950,576,570000.0,0.0025660278740695,0.0015129580878757,0.0017998360423331,0.0051036656568213,0.0017447153086452,0.0012481765946523,1.1517543859649122
3856900507,1315000.0,4,3.5,3460,3997,2.0,0,0,3,10,2560,900,98103,47.6718,-122.329,1860,4000,537,2140,16,-1600,3,599,550000.0,0.0034984479428923,0.00191779073578,0.0030417275111183,0.0061065387459883,0.0020378201897583,0.0019236540192827,2.390909090909091
1774000170,419950.0,4,1.75,1870,16549,1.0,0,0,3,8,1870,0,98072,47.7482,-122.083,1870,10804,14679,8934,51,0,-5745,272,517500.0,0.0029014875166214,0.0019756473322075,0.0033012564193548,0.0,0.0029176808338014,0.0016558128471704,0.8114975845410628
2481590090,598555.0,3,2.5,3040,7880,2.0,0,0,3,9,3040,0,98056,47.5277,-122.184,3040,7880,4840,4840,16,0,0,404,380000.0,0.0037317051314628,0.0020363967148889,0.004209150471591,0.0,0.0039413209907754,0.002490305033924,1.5751447368421052
685000115,2150000.0,8,6.0,4340,9415,2.0,0,0,3,8,4340,0,98004,47.6316,-122.202,2050,9100,5075,7050,53,-2290,-315,315,1150000.0,0.0047334438530669,0.0022843192583034,0.0056969585592208,0.0,0.0024350263695538,0.0022571952439159,1.8695652173913044
3243200310,300000.0,3,1.0,2120,7735,1.0,0,0,4,7,1060,1060,98059,47.4869,-122.123,1010,8570,5615,7560,53,-1110,835,465,435000.0,0.001891489190853,0.0011537879222942,0.0010017578014251,0.0169139939364927,0.0009232318966565,0.0014631721948795,0.6896551724137931
251200200,464900.0,4,2.25,2020,8424,1.0,0,0,4,7,1380,640,98034,47.7262,-122.233,2030,7236,6404,5206,41,10,-1188,543,446000.0,0.0018810505574241,0.0015878296551314,0.0015291197588866,0.0037342170980465,0.0019540932477896,0.0015694079107181,1.0423766816143498
9558050780,380000.0,4,2.5,1940,3200,2.0,0,0,3,8,1940,0,98058,47.4583,-122.118,1900,3200,1260,1300,16,-40,0,451,335000.0,0.0020933775892059,0.0003624924117311,0.0023777948281736,0.0,0.0021281862588613,0.0005142945766833,1.1343283582089552
1523069215,435000.0,3,1.75,2220,132858,1.0,0,0,3,7,1110,1110,98027,47.4853,-122.034,2130,77536,130638,75406,32,-90,-55322,411,571000.0,0.0021468379108365,0.0098167050383005,0.0012772288506436,0.0067268650384825,0.0021803686972757,0.0066200077473625,0.7618213660245184
4310701575,429000.0,3,3.25,1410,1246,3.0,0,0,3,8,1410,0,98103,47.6981,-122.34,1410,1253,-164,-157,15,0,7,599,550000.0,0.0014256680923347,0.0005978401943412,0.0016753264807331,0.0,0.0015447991761071,0.0006025846215403,0.78
7100000110,340000.0,3,1.0,1580,8308,1.5,0,0,3,7,1580,0,98146,47.5075,-122.379,1200,8308,6728,7108,72,-380,0,281,312000.0,0.0034562867230464,0.0032811863771523,0.00407954598268,0.0,0.0027756061229871,0.0035769364237007,1.0897435897435896
3124059006,1250000.0,4,3.25,3820,24166,2.0,0,1,4,11,3310,510,98040,47.5263,-122.227,2900,18786,20346,15886,30,-920,-5380,282,993750.0,0.0043600984788734,0.006253074333337,0.0047437446346241,0.0028592893264411,0.0035476349508102,0.0052039328945844,1.2578616352201255
7399100210,140000.0,3,1.5,1200,2002,2.0,0,0,3,8,1200,0,98055,47.4659,-122.189,1270,1848,802,578,54,70,-154,260,297225.0,0.0025807450610991,0.000763442032937,0.0029081743935244,0.0,0.0027339167124113,0.0009354011367553,0.4710236352931281
9433000460,779950.0,4,2.75,2990,4298,2.0,0,0,3,9,2990,0,98052,47.7101,-122.108,2990,4837,1308,1847,6,0,539,571,615000.0,0.0022121634958989,0.0006770689750234,0.0024883323013828,0.0,0.0022424063795336,0.0008429093669414,1.2682113821138212
4319200675,760000.0,4,2.25,3300,8365,3.0,0,0,3,9,3300,0,98126,47.5363,-122.377,1290,8369,5065,7079,6,-2010,4,352,396587.5,0.006067927692367,0.0046593676405385,0.0075074562690672,0.0,0.0025949782142526,0.0047391325275279,1.916348851136256
9201000480,550000.0,3,1.75,1840,9401,1.0,0,0,3,8,1840,0,98075,47.5847,-122.075,2850,14323,7561,11473,49,1010,4922,358,739999.5,0.0017020379128945,0.0013807827529791,0.0018124918117727,0.0,0.002668996653921,0.00265730077758,0.7432437454349631
1018000276,217000.0,3,2.5,1340,4200,2.0,0,0,3,7,1340,0,98002,47.2942,-122.226,990,4520,2860,3530,18,-350,320,197,235000.0,0.0041796500946659,0.002839138470191,0.004471660020356,0.0,0.0033990599367568,0.0030238664681975,0.9234042553191488
50300220,363000.0,4,2.5,2180,9281,2.0,0,0,3,8,2180,0,98042,47.3673,-122.072,2520,9520,7101,7000,16,340,239,546,292000.0,0.0020133397612437,0.0008946666646101,0.0021611804407221,0.0,0.0023582544051162,0.001183658549322,1.2431506849315068
1226039124,529000.0,2,2.0,1540,9714,2.0,0,0,3,8,1540,0,98177,47.7628,-122.359,1840,8179,8174,6339,12,300,-1535,254,557000.0,0.0026071646238233,0.0032081047412842,0.0032969950245347,0.0,0.0033135242211417,0.0027511783075695,0.9497307001795332
2481630290,879000.0,4,2.75,4230,31747,2.0,0,0,4,10,4230,0,98072,47.731,-122.132,4080,35576,27517,31496,35,-150,3829,272,517500.0,0.0065632578584539,0.0037900100220915,0.0074675479432466,0.0,0.0063658490919303,0.0054523507822045,1.6985507246376812
3816300105,435000.0,4,2.5,2060,10125,2.0,0,0,4,7,1560,500,98028,47.764,-122.262,1760,9876,8065,8116,41,-300,-249,282,442500.0,0.003439231615554,0.0030168505629517,0.0031045332155202,0.0051824212271973,0.0029846291598268,0.0034638034989465,0.9830508474576272
2473251180,255000.0,3,1.0,1180,13650,1.0,0,0,4,7,1180,0,98058,47.4551,-122.154,1460,11730,12470,10270,53,280,-1920,451,335000.0,0.0012732915233314,0.0015462566937905,0.0014462875758994,0.0,0.0016353431252303,0.0018852110576548,0.7611940298507462
5096300140,398500.0,3,2.5,1630,1971,2.0,0,0,3,8,1630,0,98177,47.7753,-122.375,1630,3451,341,1821,24,0,1480,254,557000.0,0.0027595313875533,0.0006509341615267,0.0034896765519426,0.0,0.0029353502611201,0.001160816278203,0.7154398563734291
2726049034,2000000.0,3,3.25,2610,16387,2.0,1,4,3,9,2610,0,98125,47.7175,-122.278,2590,12958,13777,10368,14,-20,-3429,402,425000.0,0.003706080812441,0.005298601255924,0.0045604415765498,0.0,0.0038821388636574,0.0044023499130945,4.705882352941177
7853270100,730000.0,4,2.5,3470,14271,2.0,0,0,3,9,3470,0,98065,47.5423,-121.877,3450,9380,10801,5930,15,-20,-4891,305,500000.0,0.0044060694559075,0.0027141312840003,0.0046163260962111,0.0,0.0044743889865184,0.0027166302663311,1.46
205000310,850000.0,4,3.5,3920,37122,2.0,0,0,3,10,3920,0,98053,47.6316,-121.988,2550,32647,33202,30097,24,-1370,-4475,400,635000.0,0.0037402224669057,0.00263357358668,0.0038536175835065,0.0,0.0025767596489543,0.0028099606896423,1.3385826771653544
3876800710,350000.0,3,1.75,1000,8268,1.0,0,0,3,6,1000,0,98072,47.7417,-122.172,1220,7800,7268,6580,51,220,-468,272,517500.0,0.0015515976024713,0.0009870476852191,0.0017653777643609,0.0,0.0019035136990576,0.0011954220851471,0.6763285024154589
5710500060,688888.0,3,3.25,2580,9825,1.5,0,1,4,9,1760,820,98027,47.5314,-122.054,2140,10270,7245,8130,42,-440,445,411,571000.0,0.0024949737882695,0.0007259564873873,0.0020251556550745,0.0049693957941942,0.0021906051700329,0.0008768504896488,1.2064588441331
1326059182,1089000.0,5,3.25,5600,107157,2.0,0,0,3,10,3440,2160,98072,47.7341,-122.102,3470,75794,101557,72324,32,-2130,-31363,272,517500.0,0.0086889465738397,0.0127925821002698,0.0060728995094015,0.0276759859569997,0.0054140922424015,0.0116161309643132,2.1043478260869564
1795910360,475000.0,3,2.5,2130,8022,2.0,0,0,3,8,2130,0,98052,47.7252,-122.106,2130,7605,5892,5475,35,0,-417,571,615000.0,0.0015758890455735,0.001263715057617,0.0017726246829248,0.0,0.0015974333071594,0.0013252689137046,0.7723577235772358
6821102170,794154.0,4,2.0,2210,8556,1.0,0,1,4,8,1210,1000,98199,47.6498,-122.396,2190,7975,6346,5785,66,-20,-581,316,689900.0,0.0032344461193964,0.0049774513773508,0.002405997096896,0.0055444666223109,0.0034785094825121,0.0047778981322162,1.1511146542977244
8562500200,375000.0,3,1.75,960,8106,1.0,0,0,3,7,960,0,98052,47.6737,-122.156,1650,8035,7146,6385,58,690,-71,571,615000.0,0.000710259851526,0.0012769476760213,0.0007989294345576,0.0,0.0012374483365319,0.0014002019357813,0.6097560975609756
9510970050,583000.0,4,2.5,1840,4011,2.0,0,0,3,9,1840,0,98052,47.6662,-122.083,2120,4011,2171,1891,15,280,0,571,615000.0,0.0013613313820916,0.0006318575288085,0.0015312814162355,0.0,0.0015899336202713,0.0006989682594174,0.9479674796747968
2997800090,575000.0,3,1.0,1220,5652,1.0,0,0,3,6,1220,0,98116,47.5767,-122.408,1490,2467,4432,977,115,270,-3185,329,565500.0,0.0019990430810169,0.0034501092351464,0.002611513778946,0.0,0.0026725067216234,0.0015218972451007,1.0167992926613616
7896300070,265000.0,4,1.0,1290,6034,1.0,0,0,3,6,1050,240,98118,47.5223,-122.286,1060,6034,4744,4974,70,-230,0,498,370000.0,0.0015269759838637,0.0020936544297411,0.0015806944517624,0.0013293305712798,0.0013198082044756,0.0021798880937792,0.7162162162162162
4058000060,416000.0,3,2.0,2220,94300,1.0,0,0,5,7,1640,580,98010,47.3459,-121.95,2070,80100,92080,78030,44,-150,-14200,99,359999.0,0.0105508794775888,0.017635144018161,0.0083382481543999,0.0422586520947176,0.0104796330609641,0.0174163374377327,1.155558765441015
6204410330,432000.0,4,1.75,2410,8400,1.0,0,0,3,7,1600,810,98011,47.7341,-122.2,1850,8400,5990,6550,42,-560,0,194,470000.0,0.0055060040575366,0.0038199511501008,0.004209097437975,0.0140686061658706,0.0042379190671996,0.0045496225708942,0.9191489361702128
625059036,2700000.0,5,4.0,4230,27295,2.0,1,4,3,8,3230,1000,98033,47.6803,-122.214,2660,27295,23065,24635,71,-1570,0,431,678000.0,0.0041247809624293,0.0060266674792014,0.0036412295406301,0.007223032807015,0.0027961089935899,0.0063779071818809,3.982300884955752
5561400740,593500.0,5,3.25,4300,50405,2.0,0,0,3,8,3220,1080,98027,47.4615,-122.0,2680,41684,46105,39004,48,-1620,-8721,411,571000.0,0.0041582896471159,0.0037243599742246,0.0037051143234886,0.0065450578752802,0.0027433746989197,0.0035589713544812,1.039404553415061
3629960590,376000.0,2,2.0,1340,1635,2.0,0,0,3,8,1340,0,98029,47.5476,-122.005,1410,1375,295,-35,17,70,-260,320,574500.0,0.0018355158621445,0.0005879404249137,0.0019302794583693,0.0,0.0019920037297091,0.0006093853318513,0.6544821583986075
1651500040,1980000.0,4,4.0,4360,12081,2.0,0,0,3,10,4360,0,98004,47.6377,-122.219,2180,10800,7721,8620,13,-2180,-1281,315,1150000.0,0.0047552569583805,0.0029311588910849,0.0057232118244706,0.0,0.0025894426759158,0.0026788690806915,1.7217391304347829
7853302520,475000.0,4,2.5,2320,10046,2.0,0,0,3,7,2320,0,98065,47.5406,-121.887,2320,5253,7726,2933,14,0,-4793,305,500000.0,0.0029458447082724,0.0019105993188331,0.0030864197530864,0.0,0.0030088644778906,0.0015213708730317,0.95
2887703155,642000.0,6,1.0,1530,4305,1.5,0,0,4,7,1530,0,98115,47.6862,-122.31,1530,3800,2775,2270,99,0,-505,576,570000.0,0.0014487168440319,0.0013712178038537,0.0018861295512121,0.0,0.0015702437777807,0.0012481765946523,1.1263157894736842
2212600040,229500.0,3,1.75,1770,33224,1.0,0,0,4,8,1770,0,98092,47.3377,-122.194,1690,22069,31454,20379,52,-80,-11155,351,309780.0,0.0022966820081564,0.0029129504424924,0.0024421641713819,0.0,0.0022604522509556,0.0020811816441834,0.7408483439860546
9275200080,295000.0,3,1.5,720,7450,1.0,0,1,1,5,720,0,98126,47.584,-122.375,2600,7360,6730,4760,96,1880,-90,352,396587.5,0.0013239114965164,0.0041497057886446,0.0016379904587055,0.0,0.0052301886488813,0.0041677638191666,0.7438459356384153
1623300765,469000.0,2,1.0,1030,4400,1.0,0,0,3,7,1030,0,98117,47.681,-122.361,1400,4200,3370,2800,96,370,-200,548,545000.0,0.0011100358013488,0.0017319132169776,0.001408165720598,0.0,0.0016588070807365,0.0016510959149135,0.8605504587155963
3629980920,645000.0,4,2.75,2330,3917,2.0,0,0,3,9,2330,0,98029,47.5527,-121.99,2620,4400,1587,1780,16,290,483,320,574500.0,0.0031916059394005,0.0014085398436617,0.003356381446269,0.0,0.0037014537388921,0.0019500330619241,1.122715404699739
6199000141,349950.0,4,2.0,1764,15600,1.0,0,0,5,7,1764,0,98058,47.4318,-122.181,1490,22387,13836,20897,78,-274,6787,451,335000.0,0.0019034629213192,0.0017671505071891,0.0021620773592259,0.0,0.0016689460661597,0.0035979727150655,1.0446268656716418
2193340260,596500.0,4,2.25,1770,8505,2.0,0,0,3,8,1770,0,98052,47.6904,-122.102,1880,8939,6735,7059,34,110,434,571,615000.0,0.0013095416012512,0.0013398026134421,0.0014730261449657,0.0,0.0014099411349576,0.0015577355449843,0.969918699186992
23500190,515000.0,4,2.25,2470,7800,1.0,0,0,3,8,1470,1000,98052,47.6913,-122.115,2050,8050,5330,6000,45,-420,250,571,615000.0,0.0018274394096556,0.0012287431375483,0.0012233606966664,0.0066662222518498,0.0015374358120548,0.0014028158784119,0.8373983739837398
3755100540,431200.0,5,1.75,1360,10609,1.0,0,0,3,7,1060,300,98034,47.7203,-122.229,1490,9935,9249,8445,54,130,-674,543,446000.0,0.0012664498802459,0.0019996776841512,0.0011745412640723,0.0017504142647093,0.0014342851917273,0.0021547909885274,0.9668161434977578
1839900080,335000.0,3,1.0,950,8000,1.0,0,0,3,7,950,0,98034,47.7193,-122.184,2270,8540,7050,6270,52,1320,540,543,446000.0,0.0008846524898777,0.0015079104037335,0.0010526549064799,0.0,0.0021851190504839,0.0018522310057397,0.7511210762331838
3362401763,441750.0,2,1.5,1020,1060,3.0,0,0,3,8,1020,0,98103,47.6801,-122.348,1340,1415,40,75,12,320,355,599,550000.0,0.0010313343646676,0.0005085959919756,0.0012119383052112,0.0,0.001468107018428,0.0006804926093212,0.8031818181818182
3579800405,440000.0,4,2.5,2300,10880,1.0,0,0,4,7,1190,1110,98028,47.7341,-122.242,1960,10400,8580,8440,59,-340,-480,282,442500.0,0.0038399187940651,0.0032418107777694,0.0023682016195314,0.0115049751243781,0.0033237915643526,0.0036475857016043,0.9943502824858758
510002519,466000.0,2,1.5,1140,1058,3.0,0,0,3,7,1140,0,98103,47.6608,-122.333,1170,1116,-82,-54,15,30,58,599,550000.0,0.0011526678193344,0.0005076363768964,0.0013545192822948,0.0,0.0012818546354931,0.0005366994713798,0.8472727272727273
2025049203,399950.0,2,1.0,710,1157,2.0,0,0,4,7,710,0,98102,47.6413,-122.329,1370,1173,447,-197,77,660,16,104,710000.0,0.0031737659191181,0.003085859986771,0.0038956620979512,0.0,0.0067399699899146,0.0034142110349163,0.5633098591549296
1516000055,650000.0,3,2.25,2150,21235,1.0,0,3,4,8,1590,560,98166,47.4336,-122.339,2570,18900,19085,16330,61,420,-2335,250,392500.0,0.0041417200274316,0.0062173013428024,0.0037109648508612,0.0061777424763921,0.005438808118003,0.0059404876291702,1.6560509554140128
4083304355,675000.0,4,1.75,1530,3615,1.5,0,0,4,7,1530,0,98103,47.6529,-122.334,1650,4200,2085,2550,107,120,585,599,550000.0,0.0015470015470015,0.0017345042556529,0.0018179074578168,0.0,0.001807743716721,0.0020198367202468,1.2272727272727273
3885804305,949000.0,4,1.75,2490,7834,1.0,0,3,4,8,1240,1250,98033,47.6851,-122.209,3210,7834,5344,4624,62,720,0,431,678000.0,0.002428062552352,0.0017297275336898,0.0013978714025948,0.0090287910087687,0.0033742518306104,0.0018305376392326,1.3997050147492625
1853080730,835000.0,3,2.5,2960,6856,2.0,0,0,3,10,2960,0,98074,47.5906,-122.057,3320,6856,3896,3536,11,360,0,435,645000.0,0.002566038651824,0.0010802922146321,0.0027817222055673,0.0,0.002946917320329,0.0011927714155183,1.2945736434108528
7202300040,808000.0,4,2.5,3480,6262,2.0,0,0,3,9,3480,0,98053,47.6857,-122.045,3490,6629,2782,3139,17,10,367,400,635000.0,0.0033204015777632,0.0004442497117555,0.0034210686710721,0.0,0.0035266239901375,0.0005705648118246,1.27244094488189
1498303855,718000.0,4,2.75,2930,4408,1.0,0,0,5,8,1660,1270,98144,47.5841,-122.295,2200,4000,1478,1800,81,-730,-408,340,452500.0,0.0045078032690035,0.003165400051847,0.0032988805666125,0.0086522281190601,0.0036740944609685,0.0029981231748925,1.5867403314917128
1155620190,430000.0,4,2.25,1790,7203,1.0,0,0,4,7,1110,680,98155,47.7709,-122.294,2270,9000,5413,6730,47,480,1797,442,377225.0,0.0022726118531308,0.0015815999520447,0.0017042052415826,0.0049886288606852,0.0029875378871131,0.0020718589754657,1.139903240771423
2725069164,785000.0,4,2.5,2990,9374,2.0,0,0,3,9,2990,0,98074,47.6287,-122.024,2440,8711,6384,6271,17,-550,-663,435,645000.0,0.0025920458003223,0.0014770506446851,0.0028099153360292,0.0,0.002165806705302,0.0015154947200379,1.2170542635658914
1321059052,449000.0,5,2.5,2570,61855,1.0,0,0,4,7,1470,1100,98092,47.3013,-122.109,1990,49658,59285,47668,39,-580,-12197,351,309780.0,0.0033347303734249,0.0054232045996981,0.0020282380406392,0.0239599215857111,0.002661715964143,0.0046829180337515,1.4494157143779456
4034900065,459900.0,3,1.75,2580,11000,1.0,0,0,4,7,1290,1290,98006,47.5646,-122.181,2280,17643,8420,15363,69,-300,6643,490,760184.5,0.0018251647777154,0.001671584925404,0.0011445088859137,0.0045034037353813,0.0016716951942429,0.0029531873852047,0.6049847109484605
3392100140,215000.0,3,1.0,1280,9775,1.0,0,0,3,6,1280,0,98003,47.3262,-122.334,1230,8750,8495,7520,56,-50,-1025,276,269500.0,0.0024011540546675,0.0033332901398038,0.0027881000405145,0.0,0.0023699650285648,0.0032444009056142,0.7977736549165121
7214700350,521000.0,4,1.75,2020,36400,1.0,0,0,4,8,1550,470,98077,47.7627,-122.076,2520,38255,34380,35735,44,500,1855,196,652475.0,0.0036094309785667,0.0033724856683256,0.0029567456721827,0.0132693393562958,0.004623344218985,0.0042774870895476,0.7984980267443197
1324300290,485000.0,3,2.75,1670,3330,1.5,0,0,4,7,1670,0,98107,47.6551,-122.36,1370,5000,1660,3630,95,-300,1670,264,529975.0,0.0040000958106781,0.0039451330327292,0.00479871268067,0.0,0.003412204234122,0.0054975140241582,0.915137506486155
1118001645,1400000.0,3,3.25,3020,6073,2.0,0,0,4,9,3020,0,98112,47.6332,-122.29,3020,7700,3053,4680,66,0,1627,268,917500.0,0.0045087278221351,0.0045374193268809,0.005621930742281,0.0,0.004938667312073,0.0058617316468801,1.5258855585831064
2206500105,290000.0,3,1.0,960,9000,1.0,0,0,4,7,960,0,98006,47.5765,-122.154,1520,9000,8040,7480,65,560,0,490,760184.5,0.0006791310800801,0.0013676603935123,0.0008517275430055,0.0,0.0011144634628286,0.001506472055027,0.3814863365406687
5422560660,407000.0,2,2.5,1700,6635,2.0,0,0,4,8,1700,0,98052,47.6655,-122.13,1700,6635,4935,4935,44,0,0,571,615000.0,0.0012577518204107,0.0010452193227734,0.0014147708736959,0.0,0.0012749467709723,0.0011562339569271,0.6617886178861788
5101405335,414900.0,3,1.5,1260,9570,1.0,0,0,3,7,870,390,98115,47.7004,-122.305,1620,7000,8310,5380,79,360,-2570,576,570000.0,0.0011930609303792,0.0030482124002044,0.0010725050389245,0.0015923436849282,0.0016626110588266,0.0022992726743595,0.7278947368421053
7950302345,345000.0,3,1.0,1010,3060,1.5,0,0,3,6,1010,0,98118,47.5657,-122.285,1330,4590,2050,3260,116,320,1530,498,370000.0,0.0011955393362034,0.001061747191748,0.0015204775202667,0.0,0.001655985765993,0.0016582178240713,0.9324324324324323
6738700225,1030000.0,4,3.25,2830,4000,2.0,0,0,3,9,1910,920,98144,47.5845,-122.291,2740,4000,1170,1260,108,-90,0,340,452500.0,0.0043539533280819,0.0028724138401516,0.0037956999290541,0.0062677558027837,0.0045759176468427,0.0029981231748925,2.276243093922652
3396200300,540000.0,3,1.75,2110,7129,1.0,0,0,3,8,1280,830,98052,47.7219,-122.102,1810,8674,5019,6864,38,-300,1545,571,615000.0,0.0015610919653334,0.0011230397214848,0.0010652392460769,0.0055329644690353,0.0013574433267411,0.0015115558918441,0.8780487804878049
6600410170,124740.0,3,1.0,1340,15600,1.0,0,0,4,6,1340,0,98042,47.3224,-122.143,1320,9800,14260,8480,42,-20,-5800,546,292000.0,0.0012375574679204,0.001503803465997,0.0013284320140218,0.0,0.0012352761169656,0.0012184720360667,0.4271917808219178
9510900360,260000.0,3,2.0,1920,8075,1.0,0,0,4,7,1510,410,98023,47.3092,-122.375,1920,7826,6155,5906,51,0,-249,492,269000.0,0.0019525589199908,0.0015635029048238,0.0017914747158851,0.0029193130358007,0.001979805979014,0.0016313023278888,0.966542750929368
8899200570,280000.0,3,2.25,1900,7800,1.0,0,0,4,8,1390,510,98055,47.4545,-122.208,1730,7800,5900,6070,43,-170,0,260,297225.0,0.0040861796800736,0.0029744494789755,0.0033686353391658,0.0097417481662591,0.0037241542617886,0.0039481216811102,0.9420472705862564
9315600050,1675000.0,5,3.25,4560,19080,1.0,0,0,5,9,2490,2070,98004,47.6291,-122.226,3390,20140,14520,16750,57,-1170,1060,315,1150000.0,0.0049733880115173,0.0046292948962751,0.0032685315236082,0.0133488102147417,0.0040267021428232,0.0049955947486228,1.4565217391304348
8651511060,530000.0,4,2.25,1980,15086,2.0,0,0,3,8,1980,0,98074,47.647,-122.064,2100,10927,13106,8827,39,120,-4159,435,645000.0,0.0017164718008823,0.0023770840650438,0.0018607466104808,0.0,0.0018640139676779,0.0019010229371891,0.8217054263565892
5360200054,247500.0,3,2.0,1530,8749,1.0,0,0,3,7,1530,0,98023,47.2974,-122.372,1750,8749,7219,6999,25,220,0,492,269000.0,0.0015559453893677,0.0016940045714307,0.0018152028578174,0.0,0.0018045106579555,0.0018236984496166,0.9200743494423792
3782400190,329500.0,3,2.25,1500,9656,1.0,0,0,3,7,1170,330,98019,47.7327,-121.982,1690,9656,8156,7966,31,190,0,190,401250.0,0.0036355175522787,0.0012756805688457,0.0030241466478497,0.0128354725787631,0.0042280970811119,0.0013729293201596,0.821183800623053
424069233,660000.0,3,2.25,2675,40910,2.0,0,0,3,8,2675,0,98075,47.5916,-122.055,2300,39438,38235,37138,36,-375,-1472,358,739999.5,0.0024744301179308,0.0060087035873179,0.0026350084763543,0.0,0.0021539271242169,0.007316807098108,0.8918924945219557
9358000780,275000.0,2,1.0,830,5610,1.0,0,0,3,6,830,0,98126,47.5674,-122.367,1310,2793,4780,1483,98,480,-2817,352,396587.5,0.0015261757529286,0.0031248120099726,0.0018882390010078,0.0,0.0026352104346286,0.0015815984167027,0.693415702713777
8929000140,491234.0,4,2.5,1540,1860,2.0,0,0,3,8,1540,0,98029,47.5521,-121.999,1210,1090,320,-120,6,-330,-770,320,574500.0,0.0021094734535093,0.0006688496577,0.0022183808700662,0.0,0.0017094500091829,0.0004830763721584,0.8550635335073977
9441300030,615000.0,3,1.75,2620,8280,1.0,0,0,4,7,1330,1290,98177,47.7235,-122.359,1530,8160,5660,6630,72,-1090,-120,254,557000.0,0.0044355657885826,0.0027345179388339,0.0028474047939164,0.010437906592873,0.0027552674230145,0.0027447872588051,1.104129263913824
2323059074,137124.0,3,1.0,960,27442,1.0,0,0,4,6,960,0,98058,47.4676,-122.134,1100,29019,26482,27919,50,140,1577,451,335000.0,0.001035898188473,0.0031085989883516,0.0011766407397148,0.0,0.0012321078340776,0.0046638482252417,0.4093253731343284
6719600030,837000.0,5,2.75,2940,5225,2.0,0,0,3,8,2760,180,98052,47.6879,-122.107,3090,6261,2285,3171,10,150,1036,571,615000.0,0.0021751707952986,0.0008231003709859,0.0022969221243533,0.0011999200053329,0.0023174032484143,0.0010910596540046,1.3609756097560977
1442880340,427874.0,3,3.0,2340,5002,2.0,0,0,3,8,2340,0,98045,47.4831,-121.773,2790,5375,2662,2585,7,450,373,218,404750.0,0.0051848487198519,0.0004535394117769,0.0055193235290648,0.0,0.0066782358925258,0.0007598409295985,1.0571315626930204
7812800215,235000.0,4,1.0,1500,6360,1.5,0,0,3,6,1500,0,98178,47.4979,-122.24,1190,6360,4860,5170,76,-310,0,258,279500.0,0.003347616497054,0.0029669963640299,0.0043722855393942,0.0,0.0027945424230326,0.0030312490318829,0.8407871198568873
9828702336,610000.0,2,2.0,1210,740,2.0,0,0,3,8,780,430,98112,47.6206,-122.3,1480,1171,-470,-309,6,270,431,268,917500.0,0.001806477041319,0.0005528882433545,0.0014520218473441,0.0032421020885169,0.0024202740469762,0.0008914399686359,0.6648501362397821
7852020790,490000.0,3,2.5,2230,5348,2.0,0,0,3,8,2230,0,98065,47.5347,-121.866,2190,5205,3118,3015,20,-40,-143,305,500000.0,0.0028315662497619,0.0010171098105832,0.0029666879523201,0.0,0.0028402643131812,0.0015074691403255,0.98
7883601155,240000.0,3,2.0,1330,6000,1.0,0,0,4,7,630,700,98108,47.5255,-122.327,1140,6000,4670,4860,120,-190,0,185,345000.0,0.0042151300985643,0.0062162573779204,0.0026215046604527,0.00930727296902,0.0039217035329732,0.0064125652077724,0.6956521739130435
6600000330,718500.0,3,1.5,1200,6240,1.0,0,0,3,8,1030,170,98112,47.6222,-122.287,2810,6240,5040,3430,68,1610,0,268,917500.0,0.0017915474789941,0.0046621927547731,0.0019174134650825,0.001281761290809,0.0045952500486507,0.0047502864255236,0.7831062670299728
6117502455,375000.0,3,1.0,1190,9486,1.0,0,0,4,7,1190,0,98166,47.4319,-122.339,2100,10400,8296,8300,67,910,914,250,392500.0,0.0022923938756482,0.0027773638115292,0.0027773887877514,0.0,0.004444162275411,0.0032688397536174,0.9554140127388536
1722069145,760000.0,4,2.5,3580,97574,2.0,0,0,3,9,3580,0,98038,47.3901,-122.071,2510,27068,93994,24558,16,-1070,-70506,586,342750.0,0.002840003109724,0.0065502048558544,0.0029689537009085,0.0,0.0020203499954522,0.0023081840080061,2.2173595915390227
3579000370,448500.0,3,2.25,1830,7943,2.0,0,0,3,8,1830,0,98028,47.7466,-122.249,2100,8070,6113,5970,35,270,127,282,442500.0,0.0030552397361474,0.0023667006441013,0.0036418562720526,0.0,0.0035612052475207,0.0028303862126872,1.0135593220338983
125059179,510000.0,6,4.5,3300,7200,2.0,0,0,3,8,3300,0,98052,47.6798,-122.104,2470,7561,3900,5091,40,-830,361,571,615000.0,0.0024415182396209,0.00113422443466,0.002746319931292,0.0,0.0018524226613538,0.0013176013486549,0.8292682926829268
922059169,800000.0,6,4.25,5480,189050,2.0,0,0,4,10,5140,340,98031,47.412,-122.168,2470,10429,183570,7959,29,-3010,-178621,271,288400.0,0.0104650851911405,0.0574692901805487,0.0110994502101121,0.0056142668428005,0.0047686435622346,0.0045335712056282,2.7739251040221915
6204050040,489900.0,4,2.5,2090,4196,2.0,0,0,3,8,2090,0,98011,47.7453,-122.192,2640,4503,2106,1863,14,550,307,194,470000.0,0.004774916381847,0.0019081565506932,0.0054981335283548,0.0,0.006047625047247,0.00243892267104,1.0423404255319149
1900000060,313000.0,3,1.5,1550,7260,1.5,0,0,2,6,1550,0,98166,47.4693,-122.349,1190,7620,5710,6430,95,-360,360,250,392500.0,0.002985891182567,0.0021256231574638,0.0036176072445502,0.0,0.0025183586227329,0.0023950537425543,0.7974522292993631
8900000110,691000.0,2,2.0,1780,3810,1.5,0,0,3,7,980,800,98119,47.6474,-122.362,1690,3810,2030,2120,98,-90,0,184,744975.0,0.0048234168759975,0.0057276007215874,0.0033498203744278,0.0104602510460251,0.0049236685700967,0.0055550776471548,0.9275479042920904
7893804845,340000.0,2,1.0,1700,6718,1.0,0,2,3,7,1230,470,98198,47.4131,-122.331,2040,7500,5018,5460,64,340,782,275,266750.0,0.0035334146711534,0.0023148020530688,0.0030266418301586,0.0062893081761006,0.0043231329999152,0.0028701696002351,1.274601686972821
238000201,440000.0,3,2.75,2070,9697,2.0,0,0,4,7,1330,740,98188,47.4327,-122.283,2000,14436,7627,12436,91,-70,4739,135,265000.0,0.0084896258412727,0.0070861348667504,0.0065977785825193,0.0175172805605529,0.0090402017773036,0.0109556106523506,1.660377358490566
2644300005,407500.0,4,2.5,1900,9075,2.0,0,0,3,7,1900,0,98133,47.7776,-122.352,1800,8460,7175,6660,32,-100,-615,484,375000.0,0.0024334078724586,0.0026421183063424,0.0028746327278449,0.0,0.0023987814190391,0.0025997308694686,1.086666666666667
1330280100,178000.0,3,1.0,1100,5734,1.0,0,0,4,7,1100,0,98030,47.3632,-122.174,1770,6050,4634,4280,65,670,316,253,283000.0,0.002206885482706,0.0019202728435108,0.0024023761684284,0.0,0.0036347954657466,0.002788328104642,0.6289752650176679
1531000140,650000.0,4,2.5,3350,46748,2.0,0,0,3,10,3350,0,98010,47.3432,-122.025,3350,39683,43398,36333,16,0,-7065,99,359999.0,0.0159213721846498,0.008742393558441,0.0170323971446584,0.0,0.0169597926348936,0.0086283710179968,1.805560571001586
1725079047,410000.0,3,2.25,2280,200811,1.0,0,0,3,7,2280,0,98014,47.6522,-121.941,2280,206038,198531,203758,42,0,5227,123,415000.0,0.008749443566089,0.0167423784247252,0.009347403635648,0.0,0.0096288663276855,0.0213561958652908,0.9879518072289156
7853360480,540000.0,4,2.5,2710,9248,2.0,0,0,3,7,2710,0,98065,47.5164,-121.875,2710,5000,6538,2290,9,0,-4248,305,500000.0,0.0034410513618182,0.0017588316245837,0.0036052575564069,0.0,0.0035146649720188,0.0014480971568929,1.08
8081020330,1320000.0,4,3.25,3470,11843,1.0,0,3,3,11,2270,1200,98006,47.5513,-122.135,3910,13247,8373,9337,31,440,1404,490,760184.5,0.0024547758832064,0.0017996891155963,0.0020139807527319,0.0041892127770989,0.0028668106181972,0.0022173594792159,1.736420566323044
2222059052,370950.0,3,2.5,2529,9653,2.0,0,0,3,7,2529,0,98042,47.3738,-122.161,2533,6125,7124,3592,8,4,-3528,546,292000.0,0.0023356588331126,0.0009305265934147,0.0025071675846726,0.0,0.0023704200032379,0.0007615450225417,1.270376712328767
3304300300,579950.0,4,2.75,2460,8643,2.0,0,0,3,9,2460,0,98059,47.4828,-122.133,3110,8626,6183,5516,9,650,-17,465,435000.0,0.0021948412308955,0.0012892293487251,0.00232483414293,0.0,0.0028428229689126,0.0014727331800502,1.3332183908045978
1241500351,1031000.0,3,2.5,4110,35741,2.0,0,0,3,7,4110,0,98033,47.6642,-122.171,2710,8865,31631,6155,44,-1400,-26876,431,678000.0,0.0040077658996654,0.0078915230765392,0.0046332673102135,0.0,0.0028486674333191,0.0020714470477147,1.5206489675516224
7809200005,292000.0,3,1.75,1650,14633,1.0,0,0,4,7,1650,0,98056,47.4984,-122.176,1370,12495,12983,11125,62,-280,-2138,404,380000.0,0.0020254320614847,0.0037815473513921,0.0022845718020148,0.0,0.001776187420185,0.0039487768272692,0.7684210526315789
7950300775,350000.0,1,1.0,790,4590,1.0,0,0,3,6,790,0,98118,47.5677,-122.285,1070,4590,3800,3520,109,280,0,498,370000.0,0.0009351248273274,0.0015926207876221,0.0011892843970403,0.0,0.0013322592252725,0.0016582178240713,0.945945945945946
2872100345,919204.0,4,3.5,3760,5000,2.0,0,0,3,9,2860,900,98117,47.6826,-122.394,1340,5000,1240,3660,6,-2420,0,548,545000.0,0.004052169527254,0.0019680832011109,0.0039100523892334,0.0045813184016289,0.0015877153487049,0.001965590374897,1.6866128440366972
8731980040,295000.0,3,2.25,1980,8000,1.0,0,0,4,9,1560,420,98023,47.3149,-122.378,2360,8000,6020,5640,46,380,0,492,269000.0,0.0020135763862405,0.0015489812060174,0.0018507950707157,0.0029905157927714,0.0024335115158714,0.0016675720193088,1.096654275092937
2484700015,579000.0,4,1.5,2480,6000,1.0,0,0,3,8,1520,960,98136,47.5233,-122.386,1810,6000,3520,4190,65,-670,0,263,489950.0,0.0054606787095183,0.0038135189245876,0.0042743454908467,0.0097416434964382,0.0041156942107417,0.0039652669054197,1.1817532401265436
1117200390,1150000.0,4,4.0,4460,103382,2.0,0,0,3,11,4460,0,98053,47.634,-121.997,3470,88519,98922,85049,19,-990,-14863,400,635000.0,0.0042554571944896,0.0073343059247389,0.0043844730669487,0.0,0.0035064141105379,0.0076189208897127,1.811023622047244
7763400035,253500.0,3,1.5,1440,12040,1.0,0,0,4,7,1440,0,98042,47.3715,-122.16,1720,12040,10600,10320,61,280,0,546,292000.0,0.0013299125028399,0.0011606278032438,0.0014275687314862,0.0,0.0016096022130158,0.0014969799300248,0.8681506849315068
4307301160,349000.0,4,2.5,2280,4096,2.0,0,0,3,7,2280,0,98056,47.4834,-122.182,2280,3600,1816,1320,17,0,-496,404,380000.0,0.0027987788485971,0.0010585128101757,0.0031568628536932,0.0,0.0029559907430816,0.0011377028073764,0.9184210526315788
5469501830,396500.0,3,2.5,2590,18980,1.0,0,0,4,10,2590,0,98042,47.3839,-122.153,3110,14652,16390,11542,44,520,-4328,546,292000.0,0.0023919954044134,0.0018296275502964,0.0025676409823259,0.0,0.0029103853967903,0.001821740027801,1.3578767123287672
5126210280,560000.0,3,2.5,3440,103672,2.0,0,0,3,9,3440,0,98038,47.3895,-121.986,2710,112820,100232,110110,30,-730,9148,586,342750.0,0.0027289415356007,0.0069595674853561,0.0028528493662361,0.0,0.0021813340588348,0.009620560062925,1.6338439095550692
1099611230,199000.0,4,1.5,1160,6400,1.0,0,0,4,7,1160,0,98023,47.3036,-122.378,1160,6400,5240,5240,45,0,0,492,269000.0,0.0011796710141611,0.0012391849648139,0.0013762322320707,0.0,0.0011961327789876,0.001334057615447,0.7397769516728625
8944310330,375000.0,3,2.5,1520,5649,2.0,0,0,4,7,1520,0,98034,47.7221,-122.162,1540,5000,4129,3460,31,20,-649,543,446000.0,0.0014154439838043,0.0010647732338363,0.0016842478503678,0.0,0.0014824155672886,0.0010844443827516,0.8408071748878924
5561000420,490000.0,4,2.25,3390,39356,1.0,0,0,4,8,1640,1750,98027,47.461,-121.992,2160,38061,35966,35901,56,-1230,-1295,411,571000.0,0.0032782795124937,0.0029079637168055,0.0018870768604103,0.0106054178534634,0.0022110781155472,0.0032496403589605,0.8581436077057794
3187600100,570000.0,3,2.0,1530,5401,1.0,0,0,4,7,1530,0,98115,47.686,-122.304,1640,5467,3871,3827,83,110,66,576,570000.0,0.0014487168440319,0.0017203129752878,0.0018861295512121,0.0,0.0016831371212813,0.0017957319586748,1.0
6414100482,500000.0,2,1.0,1630,12059,1.0,0,0,3,7,1270,360,98125,47.7228,-122.314,1660,8800,10429,7140,73,30,-3259,402,425000.0,0.0023145255648578,0.0038991781622742,0.0022190654414629,0.0027286163641186,0.0024881662214947,0.0029897113161932,1.1764705882352942
2663000345,1200000.0,4,2.5,2390,4200,2.0,0,0,3,9,2150,240,98102,47.6272,-122.318,2800,5250,1810,2450,96,410,1050,104,710000.0,0.0106835218967497,0.0112019117929459,0.0117967232543593,0.0057894102038354,0.0137751211472708,0.0152809956805718,1.6901408450704225
6885900415,290000.0,4,2.75,2240,8162,2.0,0,0,5,7,1380,860,98133,47.7427,-122.34,1550,8163,5922,6613,74,-690,1,484,375000.0,0.0028688598075302,0.0023763051918862,0.0020878911391715,0.0071759954607656,0.0020656173330614,0.0025084637219234,0.7733333333333333
3878900185,303100.0,3,1.5,1640,5650,1.0,0,0,3,8,1640,0,98178,47.509,-122.251,1640,5650,4010,4010,68,0,0,258,279500.0,0.0036600607034458,0.002635775071819,0.004780365523071,0.0,0.0038513021628349,0.0026928548789525,1.0844364937388191
273900030,267500.0,3,1.5,1600,9072,1.0,0,0,4,7,1600,0,98030,47.3737,-122.216,1710,8000,7472,6290,57,110,-1072,253,283000.0,0.0032100152475724,0.0030381435710377,0.0034943653358958,0.0,0.0035115820601281,0.0036870454276258,0.9452296819787986
1868901690,600000.0,3,1.75,2040,5000,1.5,0,0,3,7,1780,260,98115,47.6756,-122.299,1690,5000,2960,3310,96,-350,0,576,570000.0,0.0019316224587092,0.0015925874609218,0.0021943206543513,0.0010615624566188,0.0017344522774179,0.0016423376245425,1.0526315789473684
2579500110,2367000.0,3,2.25,3530,17450,1.0,1,3,3,9,1840,1690,98040,47.5358,-122.213,3530,17310,13920,13780,90,0,-140,282,993750.0,0.0040290962383307,0.0045152754744985,0.0026370060808786,0.0094748999248735,0.0043183280608138,0.0047950643247768,2.38188679245283
6123000090,267000.0,3,1.5,1030,8223,1.0,0,0,4,7,1030,0,98148,47.4282,-122.331,1460,9463,7193,8003,68,430,1240,56,279000.0,0.0113348739958182,0.0163472300361217,0.0122911694510739,0.0,0.0161826645976501,0.01916665653951,0.956989247311828
9274200322,580000.0,3,2.5,1740,1236,3.0,0,2,3,8,1740,0,98116,47.5891,-122.387,1740,1280,-504,-460,12,0,44,329,565500.0,0.0028510942303028,0.0007544824866668,0.0037246180125952,0.0,0.003120913889681,0.0007896345657595,1.0256410256410255
5560000480,169950.0,3,1.0,840,8470,1.0,0,0,4,6,840,0,98023,47.3275,-122.338,840,8450,7630,7610,59,0,-20,492,269000.0,0.0008542445274959,0.0016399838518709,0.0009965819611546,0.0,0.0008661651158186,0.0017613729453949,0.6317843866171003
1355300009,625000.0,2,2.25,1390,916,2.0,0,0,3,8,1165,225,98122,47.6168,-122.314,1415,1488,-474,73,13,25,572,289,574000.0,0.0026887752338654,0.000904511795683,0.0026956735018765,0.0026536148130675,0.0028603309493873,0.0014472244510905,1.088850174216028
856000635,2225000.0,4,4.25,4700,10800,2.0,0,1,3,11,3910,790,98033,47.6882,-122.214,2370,7680,6100,5310,18,-2330,-3120,431,678000.0,0.0045830899582548,0.0023846128879053,0.0044078041807628,0.0057061959175418,0.0024912700431609,0.0017945531107106,3.281710914454277
721049207,275000.0,3,1.75,1860,15681,1.0,0,0,4,7,1860,0,98023,47.3191,-122.339,1860,22979,13821,21119,49,0,7298,492,269000.0,0.0018915414537411,0.0030361967864448,0.0022067171996996,0.0,0.0019179370421698,0.0047898921789621,1.0223048327137547
8665900336,360000.0,3,2.0,1930,15540,1.0,0,0,3,8,1260,670,98155,47.7675,-122.307,1900,12123,13610,10223,62,-30,-3417,442,377225.0,0.002450358031588,0.0034121981472686,0.0019345032472018,0.0049152666715574,0.0025005823724735,0.0027907940399523,0.9543375969249122
2597690050,350000.0,4,1.75,1770,7336,1.0,0,0,4,8,1770,0,98058,47.4265,-122.163,2030,8183,5566,6153,34,260,847,451,335000.0,0.0019099372849971,0.0008310138538935,0.0021694313638491,0.0,0.0022737990028887,0.0013151476628124,1.044776119402985
9106000005,1310000.0,4,2.25,3750,5000,2.0,0,0,5,8,2440,1310,98115,47.6747,-122.303,2170,4590,1250,2420,96,-1580,-410,576,570000.0,0.0035507765785095,0.0015925874609218,0.0030079451666389,0.0053486416083487,0.0022270777763295,0.00150766593933,2.298245614035088
7972603931,240000.0,2,1.0,720,6345,1.0,0,0,3,6,720,0,98106,47.5201,-122.35,720,6345,5625,5625,77,0,0,330,315000.0,0.0014630845479983,0.0034740606211259,0.0018310314047316,0.0,0.0016004908171839,0.0037711155726568,0.7619047619047619
6181400470,215000.0,4,2.5,2130,4496,2.0,0,0,3,7,2130,0,98001,47.3041,-122.28,3220,5400,2366,2180,16,1090,904,358,260000.0,0.0031178822992113,0.0008391239292351,0.0034456764040726,0.0,0.0049088658385623,0.0013467271164253,0.8269230769230769
1853080640,966000.0,5,4.5,3810,8019,2.0,0,0,3,10,3810,0,98074,47.5915,-122.058,3390,7713,4209,4323,12,-420,-306,435,645000.0,0.0033029078592735,0.0012635448175517,0.0035805275686526,0.0,0.0030090511192516,0.0013418678424581,1.4976744186046511
822039084,1350000.0,3,2.5,2753,65005,1.0,1,2,5,9,2165,588,98070,47.4041,-122.451,2680,72513,62252,69833,67,-73,7508,116,466250.0,0.0124853740169978,0.0058008657081518,0.0110278574375639,0.0243206353145551,0.0130305829727232,0.0077632564887315,2.89544235924933
1703050420,651100.0,4,2.5,2310,5526,2.0,0,0,3,9,2310,0,98074,47.6299,-122.02,2500,5769,3216,3269,17,190,243,435,645000.0,0.0020025504343627,0.0008707256094015,0.002170871045561,0.0,0.0022190642472357,0.0010036607783146,1.0094573643410854
1862400087,475000.0,3,1.75,1520,8100,1.0,0,0,5,6,760,760,98117,47.6966,-122.375,1040,8100,6580,7060,75,-480,0,548,545000.0,0.0016381110854856,0.0031882947857997,0.0010390349006354,0.0038686688724866,0.0012322566885471,0.0031842564073332,0.8715596330275229
8651480550,600000.0,3,2.5,2260,10153,2.0,0,0,3,10,2260,0,98074,47.641,-122.068,2740,10153,7893,7413,33,480,0,435,645000.0,0.0019592051868656,0.0015997967991773,0.0021238824947913,0.0,0.0024320944149703,0.0017663664209098,0.9302325581395348
1651500060,845000.0,5,2.0,1720,9972,1.0,0,0,4,8,1720,0,98004,47.6368,-122.218,2700,9023,8252,6323,69,980,-949,315,1150000.0,0.0018759270569758,0.0024194616722041,0.0022577808114884,0.0,0.0032071079013636,0.0022380958995443,0.7347826086956522
7600136,411000.0,2,2.0,1130,1148,2.0,0,0,3,9,800,330,98122,47.6023,-122.314,1350,1201,18,-149,13,220,53,289,574000.0,0.0021858388591855,0.0011336021194804,0.001851106267383,0.0038919683924991,0.0027289376548924,0.0011680890898922,0.7160278745644599
2818100255,922000.0,4,2.5,2620,14126,1.0,0,4,4,8,1620,1000,98117,47.6983,-122.397,2620,8905,11506,6285,79,0,-5221,548,545000.0,0.0028235862131398,0.0055602286597786,0.0022147849197755,0.0050903537795876,0.0031043389653783,0.0035007164576916,1.691743119266055
1247100035,1095000.0,4,2.75,3330,9143,2.0,0,0,4,10,3330,0,98033,47.6821,-122.19,2390,9143,5813,6753,25,-940,0,431,678000.0,0.0032471679916997,0.0020187514476035,0.0037539611053555,0.0,0.0025122934190526,0.0021364061316701,1.6150442477876106
3432500486,299995.0,2,1.0,1060,7200,1.0,0,0,4,6,1060,0,98155,47.7463,-122.315,1850,8291,6140,6441,69,790,1091,442,377225.0,0.0013457924940328,0.0015809412265337,0.0016274392397095,0.0,0.0024347775731979,0.0019086425295096,0.795268076081914
2770605065,450000.0,2,1.0,1180,6000,1.0,0,0,3,7,1180,0,98119,47.6531,-122.373,1600,6000,4820,4400,110,420,0,184,744975.0,0.0031975460189197,0.0090198436560432,0.0040334571855356,0.0,0.0046614613681389,0.008748153775047,0.6040471156750227
4101410050,675000.0,4,1.75,1900,8800,1.0,0,0,3,8,1140,760,98033,47.6579,-122.197,2280,8800,6900,6520,45,380,0,431,678000.0,0.0018527384937626,0.0019430179086635,0.0012851398378694,0.0054895049333314,0.0023966648516485,0.0020562587726892,0.995575221238938
4022900652,565000.0,5,3.25,2860,20790,1.0,0,0,4,7,1800,1060,98155,47.7757,-122.295,1920,9612,17930,7692,55,-940,-11178,442,377225.0,0.0036311005027677,0.0045649677916161,0.0027635760674312,0.0077763920475386,0.0025269042921838,0.0022127453857974,1.4977798396182649
267010020,570000.0,4,2.0,1790,7800,1.0,0,0,5,8,1790,0,98008,47.6266,-122.103,2150,7838,6010,5688,48,360,38,283,545000.0,0.0029647296547497,0.0027052045013215,0.0036922137606125,0.0,0.0037588726878562,0.0029169166278389,1.0458715596330277
6154900130,340000.0,2,1.0,860,7102,1.0,0,0,3,6,860,0,98177,47.7042,-122.369,1450,7102,6242,5652,73,590,0,254,557000.0,0.0014559490756416,0.0023454766185505,0.0018411790396752,0.0,0.0026112011525301,0.0023889067539257,0.6104129263913824
3488300110,374000.0,2,1.0,1140,5650,1.0,0,1,3,6,980,160,98116,47.5634,-122.391,1220,5700,4510,4480,100,80,50,329,565500.0,0.0018679582888191,0.0034488883896987,0.0020977733634156,0.0011178648780828,0.0021882269801212,0.0035163414256481,0.6613616268788682
2826049200,451000.0,4,1.5,1620,5444,1.5,0,0,3,8,1620,0,98125,47.7065,-122.297,1620,6912,3824,5292,65,0,1468,402,425000.0,0.0023003260215151,0.0017602724865594,0.0028306189095826,0.0,0.0024282104089286,0.0023482823429008,1.0611764705882354
7436200040,290000.0,5,2.5,2780,9652,1.0,0,0,4,8,1390,1390,98001,47.3444,-122.271,1790,9652,6872,7862,53,-990,0,358,260000.0,0.004069348728548,0.001801428862317,0.0022485869491366,0.0213879058316664,0.0027288415686417,0.002407150023655,1.1153846153846154
3305100230,820000.0,4,2.5,3170,8523,2.0,0,0,3,9,3170,0,98033,47.6854,-122.184,3230,8523,5353,5293,12,60,0,431,678000.0,0.0030911479080144,0.0018818570040386,0.0035735906017949,0.0,0.0033952752065021,0.0019915333545034,1.2094395280235988
4140930110,828200.0,4,2.75,3400,7081,2.0,0,0,3,9,3400,0,98006,47.5661,-122.123,3060,7081,3681,4021,19,-340,0,490,760184.5,0.0024052559086172,0.0010760448051623,0.0030165350481447,0.0,0.0022435909185891,0.0011852587357385,1.0894723583551098
8856940060,374950.0,4,2.75,2730,4683,2.0,0,0,3,7,2730,0,98038,47.3608,-122.043,2230,4924,1953,2694,15,-500,241,586,342750.0,0.0021657006954041,0.0003143727769689,0.0022640345261118,0.0,0.0017949723067164,0.0004198868795412,1.0939460247994164
1826049442,441000.0,3,2.5,1890,11036,1.0,0,0,3,8,1460,430,98133,47.7426,-122.354,2040,7524,9146,5484,47,150,-3512,484,375000.0,0.0024206004626036,0.0032130487745229,0.0022089283066597,0.0035879977303828,0.0027186189415776,0.0023121010711444,1.176
7931000053,362950.0,4,1.75,2140,159865,1.0,0,0,4,7,1140,1000,98031,47.4235,-122.218,1830,15569,157725,13739,60,-310,-144296,271,288400.0,0.0040867303483651,0.0485973450130305,0.0024617457664451,0.0165125495376486,0.0035330436108864,0.0067679710519154,1.258495145631068
9465910380,540000.0,4,2.25,2850,7453,2.0,0,0,3,9,2850,0,98072,47.7439,-122.174,2700,8468,4603,5768,29,-150,1015,272,517500.0,0.0044220531670434,0.000889751620457,0.0050313266284285,0.0,0.0042126942520127,0.001297799258593,1.0434782608695652
6817850050,810000.0,4,2.5,3280,25211,2.0,0,3,3,11,3280,0,98074,47.6398,-122.05,3280,25211,21931,21931,35,0,0,435,645000.0,0.002843448235805,0.0039724689356899,0.0030824489304935,0.0,0.0029114122923732,0.0043860793694038,1.255813953488372
2195700050,810000.0,4,2.5,3480,59242,2.0,0,0,3,11,3480,0,98072,47.7391,-122.102,2930,39400,55762,36470,32,-550,-19842,272,517500.0,0.0053995596566004,0.0070724091639761,0.0061435146199759,0.0,0.004571553391999,0.0060384141224099,1.565217391304348
1324079007,425000.0,3,1.75,1610,144619,1.0,0,0,3,7,1610,0,98024,47.5659,-121.863,2220,144619,143009,142399,43,610,0,79,465000.0,0.0085754613971077,0.0176404755471823,0.0092073658927141,0.0,0.0131488545097017,0.0228787312863197,0.913978494623656
6365900065,334850.0,2,1.0,870,5635,1.0,0,0,3,7,870,0,98116,47.5676,-122.398,1310,5750,4765,4440,72,440,115,329,565500.0,0.0014255471151514,0.0034397320488411,0.0018623090062976,0.0,0.0023496535606219,0.0035471865258731,0.592130857648099
3278611450,496800.0,4,2.25,1850,2340,2.5,0,0,3,8,1850,0,98126,47.543,-122.372,1850,2340,490,490,6,0,0,352,396587.5,0.0034017170396603,0.0013033975228762,0.004208725484174,0.0,0.0037214803847809,0.0013250770838111,1.252686985848016
6042000090,525000.0,4,2.5,2520,7731,2.0,0,0,3,9,2520,0,98155,47.7709,-122.297,2000,7704,5211,5704,26,-520,-27,442,377225.0,0.0031994312122289,0.0016975356419905,0.0038690064944037,0.0,0.0026321919710248,0.0017735112829986,1.3917423288488302
2624049103,449000.0,2,1.0,1250,4576,1.0,0,0,3,6,1040,210,98118,47.5387,-122.266,1550,5000,3326,3450,95,300,424,498,370000.0,0.0014796278913408,0.0015877631207317,0.0015656402188885,0.0011631642498698,0.0019299082235257,0.0018063374989884,1.2135135135135136
5631500967,476000.0,4,1.75,2340,17541,1.0,0,0,4,7,1360,980,98028,47.745,-122.229,2250,9212,15201,6962,64,-90,-8329,282,442500.0,0.0039066999904836,0.0052265259975048,0.0027065161366074,0.0101575456053068,0.003815577050915,0.0032309191810749,1.0757062146892655
7135520780,725126.0,4,2.5,3200,12369,2.0,0,0,3,10,3200,0,98059,47.5273,-122.143,3770,12960,9169,9190,22,570,591,465,435000.0,0.0028550780239291,0.0018450165237048,0.0030241744948683,0.0,0.0034461230201931,0.0022126851395144,1.6669563218390804
3260350090,701000.0,4,3.0,2910,8540,2.0,0,0,3,9,2910,0,98059,47.5223,-122.156,3040,6091,5630,3051,17,130,-2449,465,435000.0,0.0025963365780105,0.00127386539837,0.0027501086812709,0.0,0.0027788365998374,0.0010399278691961,1.6114942528735632
6403510130,490000.0,5,2.75,2990,7200,2.0,0,0,3,8,2990,0,98059,47.4955,-122.16,2710,7620,4210,4910,23,-280,420,465,435000.0,0.0026677135286087,0.0010739848791878,0.0028257130436426,0.0,0.0024771865741972,0.001300976910733,1.1264367816091954
7186800120,350000.0,4,3.0,1780,4228,1.0,0,0,3,7,1780,0,98118,47.5488,-122.287,1730,5304,2448,3574,67,-50,1076,498,370000.0,0.0021069901172693,0.0014670154008858,0.0026796534515592,0.0,0.0021540265978706,0.0019161628189269,0.945945945945946
6187700501,360000.0,4,2.0,1650,7552,1.0,0,0,4,7,860,790,98155,47.7765,-122.324,1410,7199,5902,5789,43,-240,-353,442,377225.0,0.0020948656746737,0.0016582316864975,0.0013203752322171,0.0057956129410901,0.0018556953395725,0.0016572569738197,0.9543375969249122
8632100010,365000.0,2,1.0,1250,8100,1.0,0,0,4,7,1250,0,98125,47.7294,-122.329,1710,8100,6850,6390,73,460,0,402,425000.0,0.0017749429178357,0.0026190681743445,0.0021841195289989,0.0,0.0025631109872024,0.0027518933705869,0.8588235294117647
1081310060,375000.0,5,2.5,2100,14858,1.0,0,0,5,8,2100,0,98059,47.4721,-122.123,1980,11730,12758,9750,50,-120,-3128,465,435000.0,0.0018736449532034,0.0022162871298574,0.0019846145122573,0.0,0.0018099001538415,0.0020026849295141,0.8620689655172413
148000072,600000.0,2,2.5,1830,1988,2.0,0,0,3,9,1530,300,98116,47.5779,-122.409,1800,2467,158,667,9,-30,479,329,565500.0,0.0029985646215254,0.0012135203749948,0.0032750951490061,0.0020959966464053,0.0032285316100149,0.0015218972451007,1.0610079575596818
2402100715,658500.0,2,1.0,1410,5101,1.5,0,0,3,8,1410,0,98103,47.6872,-122.333,1410,4224,3691,2814,93,0,-877,599,550000.0,0.0014256680923347,0.0024474982594981,0.0016753264807331,0.0,0.0015447991761071,0.0020313786443625,1.1972727272727273
1997200060,270000.0,1,1.0,720,5196,1.0,0,0,3,7,720,0,98103,47.6928,-122.337,1580,5762,4476,4182,109,860,566,599,550000.0,0.0007280007280007,0.0024930799757601,0.000855485862502,0.0,0.001731051559042,0.0027710236147767,0.4909090909090909
8556800090,525000.0,5,3.5,3450,19080,2.0,0,3,3,9,3450,0,98022,47.2123,-122.005,2570,17007,15630,14437,19,-880,-2073,233,280000.0,0.008058977701159,0.0011031132190774,0.0085696401247938,0.0,0.0061225462168858,0.0014176277978081,1.875
8691310840,833000.0,4,2.75,3780,10308,2.0,0,0,3,10,3780,0,98075,47.589,-121.983,3500,10740,6528,7240,21,-280,432,358,739999.5,0.0034965778862724,0.0015139994274767,0.0037234886133157,0.0,0.0032777151890258,0.0019925581478188,1.1256764362678624
9264901510,240000.0,3,1.75,1770,8571,1.0,0,0,3,8,1270,500,98023,47.3109,-122.339,2120,7711,6801,5591,42,350,-860,492,269000.0,0.0018000152543665,0.0016595397395968,0.0015067370126981,0.0035601378485374,0.0021860357684946,0.0016073309801112,0.8921933085501859
723099028,320000.0,3,2.0,1550,34175,1.5,0,0,3,7,1550,0,98045,47.4855,-121.698,2300,35174,32625,32874,21,750,999,218,404750.0,0.0034344083400728,0.0030987023985361,0.0036559621666882,0.0,0.0055053557536951,0.0049723990432931,0.7906114885731933
1088000050,678700.0,3,1.75,1970,10548,1.0,0,0,4,8,1300,670,98033,47.6669,-122.179,2500,8548,8578,6048,47,530,-2000,431,678000.0,0.0019209972803749,0.0023289719205208,0.00146551034143,0.0048394319807,0.0026279219864567,0.001997374998744,1.0010324483775812
4232903295,940000.0,3,1.5,1790,4800,1.5,0,0,3,8,1790,0,98119,47.6332,-122.362,1780,3600,3010,1820,108,-10,-1200,184,744975.0,0.0048505147236155,0.0072158749248346,0.0061185494594141,0.0,0.0051858757720545,0.0052488922650282,1.261787308298936
7214711270,528000.0,5,2.25,2940,38009,1.0,0,0,3,8,1700,1240,98077,47.7653,-122.077,2620,38300,35069,35680,43,-320,291,196,652475.0,0.0052533302361318,0.0035215606529502,0.0032428823501359,0.0350084697910784,0.0048068102594209,0.0042825187695641,0.8092264071420361
7626200280,425000.0,2,1.0,1170,5000,1.0,0,0,4,7,1030,140,98136,47.5449,-122.388,1170,5850,3830,4680,100,0,850,263,489950.0,0.0025762072944098,0.0031779324371563,0.002896431483929,0.0014206563432305,0.0026604211196507,0.0038661352327842,0.8674354525972038
2891000750,222000.0,3,2.0,1200,6074,1.0,0,0,3,7,1200,0,98002,47.325,-122.205,1430,6338,4874,4908,52,230,264,197,235000.0,0.0037429702340292,0.0041059350161763,0.0040044716600203,0.0,0.0049097532419821,0.0042401030255389,0.9446808510638298
1725059330,1100000.0,4,2.5,2570,9470,2.0,0,0,3,9,2570,0,98033,47.6548,-122.19,2570,10663,6900,8093,14,0,1193,431,678000.0,0.0025060725941946,0.0020909522267095,0.0028972012134425,0.0,0.0027015038020775,0.0024915781014983,1.6224188790560472
2724079014,721500.0,3,3.25,2970,234788,2.0,0,3,3,9,2040,930,98024,47.5353,-121.897,2970,220413,231818,217443,29,0,-14375,79,465000.0,0.0158193294095714,0.0286391965977627,0.0116664760379732,0.0721769499417927,0.0175910350873036,0.0348693449616689,1.5516129032258064
5021900175,500000.0,3,1.75,1540,10800,1.0,0,0,5,6,770,770,98040,47.5763,-122.222,2020,10800,9260,8780,73,480,0,282,993750.0,0.0017577360359856,0.0027945544484002,0.0011035297186285,0.0043169662379601,0.0024711112415988,0.002991721242495,0.5031446540880503
1545807990,315000.0,3,1.75,1890,10661,1.0,0,0,5,7,1460,430,98038,47.3583,-122.056,1680,9604,8771,7924,42,-210,-1057,586,342750.0,0.0014993312506643,0.0007156797299307,0.0012108023472979,0.0078538812785388,0.0013522661324142,0.0008189670168793,0.9190371991247264
3734900110,230000.0,2,0.75,890,19703,1.0,0,0,3,6,890,0,98045,47.4922,-121.783,1270,9800,18813,8530,86,380,-9903,218,404750.0,0.0019720151113966,0.0017865028049263,0.0020992298892597,0.0,0.0030399138292142,0.0013853843925704,0.5682520074119827
1822059057,152000.0,2,1.0,700,13500,1.0,0,0,3,4,700,0,98031,47.3882,-122.208,1600,10124,12800,8524,100,900,-3376,271,288400.0,0.0013367809550727,0.0041038636204041,0.0015115982776417,0.0,0.0030889998783706,0.0044009852225314,0.5270457697642164
6142100090,279000.0,4,2.5,1810,13000,1.0,0,0,4,8,1470,340,98022,47.2202,-121.993,1850,13000,11190,11150,43,40,0,233,280000.0,0.0042280433736515,0.0007515970570234,0.0036514118792599,0.0133281066248529,0.0044072803506765,0.0010836221186279,0.9964285714285714
1223039290,403950.0,4,2.5,2120,13780,2.0,0,0,3,8,2120,0,98146,47.4987,-122.365,1880,12000,11660,10120,27,-240,-1780,281,312000.0,0.004637549273961,0.0054423144291237,0.0054738211919503,0.0,0.0043484495926798,0.0051664945936939,1.2947115384615384
9407150250,280000.0,3,2.5,1600,7936,2.0,0,0,3,7,1600,0,98038,47.3673,-122.017,1830,7936,6336,6106,24,230,0,586,342750.0,0.0012692751328375,0.0005327487418375,0.0013269066819703,0.0,0.0014730041799512,0.0006767307628024,0.8169219547775346
993002177,345000.0,3,2.5,1380,1547,3.0,0,0,3,8,1380,0,98103,47.6908,-122.341,1380,1465,167,85,20,0,-82,599,550000.0,0.001395334728668,0.0007422622637607,0.0016396812364622,0.0,0.0015119311085303,0.0007045382845622,0.6272727272727273
2550820060,280000.0,3,1.75,1630,10001,1.0,0,0,4,7,1100,530,98042,47.3605,-122.12,1630,10001,8371,8371,43,0,0,546,292000.0,0.0015053870691868,0.0009640729784254,0.0010905038921075,0.007155393546645,0.0015253788414045,0.0012434631461942,0.958904109589041
1196003740,734000.0,5,4.25,4110,42755,2.0,0,2,3,10,2970,1140,98023,47.3375,-122.337,2730,12750,38645,10020,20,-1380,-30005,492,269000.0,0.0041796964381054,0.0082783364329092,0.0035236290769396,0.0081171142946654,0.0028150366264106,0.0026576929057734,2.7286245353159853
3448001412,295000.0,2,1.5,988,1080,3.0,0,0,3,7,988,0,98125,47.7123,-122.301,1128,1080,92,-48,13,140,0,402,425000.0,0.0014029148822573,0.0003492090899126,0.0017263280757208,0.0,0.0016907539143651,0.0003669191160782,0.6941176470588235
1207000025,245000.0,3,1.0,1370,6000,1.0,0,0,3,7,1370,0,98146,47.4879,-122.339,1370,9520,4630,8150,65,0,3520,281,312000.0,0.0029969068421351,0.0023696579517229,0.0035373278457415,0.0,0.0031688169904102,0.0040987523776638,0.7852564102564102
7461420230,336500.0,4,1.75,1760,7268,1.0,0,0,4,7,1080,680,98058,47.4267,-122.148,1830,8786,5508,6956,41,70,1518,451,335000.0,0.0018991466788672,0.0008233108901442,0.0013237208321791,0.0061344158773116,0.0020497793966927,0.0014120600471061,1.0044776119402985
2592401080,525000.0,3,2.5,1720,7950,1.5,0,0,4,7,1720,0,98034,47.7178,-122.168,1790,7030,6230,5240,48,70,-920,543,446000.0,0.0016016866132522,0.0014984859637102,0.0019058594096268,0.0,0.0017230674450952,0.0015247288021487,1.1771300448430493
1630700380,1920000.0,5,5.75,7730,230868,2.0,0,0,3,12,6660,1070,98077,47.7615,-122.084,2660,39292,223138,36632,16,-5070,-191576,196,652475.0,0.0138123274575847,0.0213900830020607,0.0127044685011207,0.0302089215132693,0.0048801966755953,0.0043934393601492,2.942641480516495
8146100410,760000.0,3,1.5,1170,7645,1.0,0,0,4,7,1170,0,98004,47.6077,-122.194,1870,7678,6475,5808,65,700,33,315,1150000.0,0.0012760666608498,0.0018548720902528,0.0015358160171171,0.0,0.0022212191761296,0.0019044774816249,0.6608695652173913
8122100690,449000.0,4,2.5,1850,5040,1.0,0,0,3,7,1230,620,98126,47.5386,-122.373,1010,5040,3190,4030,90,-840,0,352,396587.5,0.0034017170396603,0.0028073177415797,0.0027982337002886,0.0059455312619869,0.0020317271289885,0.0028540121805162,1.1321587291581303
4358700188,305000.0,3,2.5,1260,895,3.0,0,0,3,7,1160,100,98133,47.7072,-122.336,1190,1095,-365,-95,11,-70,200,484,375000.0,0.0016137336417357,0.0002605725492205,0.0017550389285789,0.0008344180768332,0.0015858610492536,0.0003364899884241,0.8133333333333334
8078440050,569500.0,4,2.5,2340,8248,2.0,0,0,3,8,2340,0,98074,47.6314,-122.03,2140,9963,5908,7823,31,-200,1715,435,645000.0,0.0020285575828609,0.0012996280901817,0.0021990641760228,0.0,0.0018995189956337,0.0017333112037353,0.8829457364341086
9358001422,335000.0,3,2.5,1090,1139,2.0,0,0,3,8,960,130,98126,47.5664,-122.369,1400,1348,49,-52,11,310,209,352,396587.5,0.0020042549044485,0.0006344315292974,0.0021839872782741,0.0012466436517069,0.0028162554263207,0.0007633350038364,0.8447064014876918
1402620120,440000.0,4,2.5,2410,7517,2.0,0,0,3,8,2410,0,98058,47.4388,-122.142,2420,8095,5107,5675,37,10,578,451,335000.0,0.0026005360773125,0.0008515173309321,0.002953858523659,0.0,0.0027106372349708,0.0013010045619536,1.3134328358208955
5561300380,450000.0,4,2.5,2500,36254,1.0,0,0,4,8,1590,910,98027,47.4685,-122.004,2360,36254,33754,33894,42,-140,0,411,571000.0,0.0024176102599511,0.0026787609662839,0.0018295440293003,0.0055148172838009,0.0024158075706905,0.0030953590702755,0.7880910683012259
9558040050,550000.0,4,2.75,3080,6731,2.0,0,3,3,9,3080,0,98058,47.4522,-122.118,3080,6731,3651,3651,17,0,0,451,335000.0,0.0033235066880176,0.0007624801323006,0.003775055706585,0.0,0.0034499019354173,0.0010817864986423,1.6417910447761197
2985800070,549995.0,3,1.0,1120,6600,1.0,0,0,3,7,1120,0,98105,47.6712,-122.267,1300,6600,5480,5300,77,180,0,229,675000.0,0.0022741947929061,0.0056278123073433,0.0028880717479538,0.0,0.002798376941374,0.0058353631850473,0.8148074074074074
2123049498,170000.0,3,1.75,1370,10780,1.0,0,0,3,7,1370,0,98168,47.4727,-122.298,1370,10317,9410,8947,61,0,-463,264,237000.0,0.003516697897682,0.0035973035573594,0.0041853786698438,0.0,0.003514334379938,0.0039993782104633,0.7172995780590717
1890000275,815000.0,3,1.5,1940,3570,2.0,0,0,4,8,1740,200,98105,47.6618,-122.325,1580,3570,1630,1990,104,-360,0,229,675000.0,0.0039392302662838,0.003044134838972,0.0044868257512854,0.0019105846388995,0.003401104282593,0.0031564009955483,1.2074074074074077
1938400300,245000.0,4,2.25,2600,6390,1.0,0,0,3,8,1390,1210,98023,47.3174,-122.366,2110,6700,3790,4590,42,-490,310,492,269000.0,0.0026440902041542,0.0012372487383064,0.0016491058642916,0.0086155335934607,0.0021757242790206,0.0013965915661711,0.9107806691449816
3797002575,605000.0,4,1.5,1880,3500,1.0,0,0,4,7,1080,800,98103,47.6835,-122.347,1690,3500,1620,1810,94,-190,0,599,550000.0,0.0019008907897796,0.001679326388599,0.001283228793753,0.0054280344408785,0.0018515678068234,0.0016831972668723,1.1
6749700117,350000.0,3,2.25,1190,1022,3.0,0,0,3,8,1190,0,98103,47.6972,-122.349,1210,1171,-168,-39,22,20,149,599,550000.0,0.0012032234254456,0.0004903633054709,0.0014139280227464,0.0,0.0013256787255954,0.000563149714145,0.6363636363636364
2874600335,560000.0,3,1.5,2000,7350,1.0,0,0,3,8,2000,0,98177,47.7061,-122.368,1890,6960,5350,5070,67,-110,-390,254,557000.0,0.0033859280828875,0.0024273800543997,0.004281811720175,0.0,0.0034035656401944,0.0023411420736867,1.0053859964093357
2824600290,605000.0,3,1.75,2100,5058,1.0,0,2,3,7,1340,760,98126,47.5743,-122.378,1640,5000,2958,3360,79,-460,-58,352,396587.5,0.0038614085315063,0.002817343876371,0.0030484822425909,0.0072880705792098,0.0032990420708328,0.0028313612901947,1.5255145459703092
8682320160,439950.0,2,2.0,1440,4666,1.0,0,0,3,8,1440,0,98053,47.709,-122.019,1510,4595,3226,3085,10,70,-71,400,635000.0,0.0013739592735571,0.0003310234996888,0.0014156146225125,0.0,0.0015258459097729,0.0003954963509329,0.6928346456692913
1109000040,315000.0,3,2.0,1300,3731,1.0,0,0,3,7,900,400,98118,47.5374,-122.27,1300,3731,2431,2431,27,0,0,498,370000.0,0.0015388130069944,0.0012945682262784,0.0013548809586535,0.002215550952133,0.0016186327036022,0.0013478890417451,0.8513513513513513
1459920010,300000.0,3,2.0,1451,7159,1.0,0,0,3,7,1451,0,98042,47.3754,-122.163,2303,6126,5708,3823,10,852,-1033,546,292000.0,0.001340071556681,0.0006901108341713,0.0014384737704072,0.0,0.002155182498009,0.0007616693564229,1.0273972602739727
423059369,392500.0,4,2.5,2150,7303,2.0,0,0,3,8,2150,0,98056,47.5109,-122.183,1940,9569,5153,7629,15,-210,2266,404,380000.0,0.0026391993528437,0.0018872849249789,0.0029768662874739,0.0,0.0025151851059554,0.0030240772677182,1.0328947368421053
9348700480,856500.0,4,2.5,3290,8147,2.0,0,0,3,10,3290,0,98052,47.7048,-122.107,3290,7467,4857,4177,17,0,-680,571,615000.0,0.0024341196995008,0.001283406454052,0.002737997749682,0.0,0.0024673969861758,0.0013012206415033,1.3926829268292682
6021502470,555000.0,2,1.0,1550,4600,1.0,0,0,4,7,1050,500,98117,47.686,-122.384,1550,4600,3050,3050,79,0,0,548,545000.0,0.0016704422253308,0.001810636545022,0.0014355087442989,0.0025451768897938,0.0018365364108154,0.0018083431449052,1.018348623853211
808300180,454000.0,4,2.5,3040,12522,2.0,0,0,3,7,3040,0,98019,47.7247,-121.959,2490,9742,9482,7252,20,-550,-2780,190,401250.0,0.0073679822392849,0.0016543156672624,0.00785761180296,0.0,0.006229563155011,0.0013851571496474,1.1314641744548286
7853321150,452000.0,4,2.5,2190,6896,2.0,0,0,3,7,2190,0,98065,47.5191,-121.869,2190,5900,4706,3710,13,0,-996,305,500000.0,0.0027807758237572,0.0013115163152173,0.0029134738186462,0.0,0.0028402643131812,0.0017087546451336,0.904
3293400010,950000.0,5,2.5,3450,35880,2.0,0,0,3,11,3450,0,98052,47.7173,-122.099,3450,26820,32430,23370,28,0,-9060,571,615000.0,0.0025524963414219,0.0056522184327223,0.0028711526554417,0.0,0.0025873919763849,0.0046737294234792,1.5447154471544715
5152000030,305000.0,5,2.5,2500,12220,1.0,0,0,3,8,1690,810,98003,47.3335,-122.325,2130,12000,9720,9870,58,-370,-220,276,269500.0,0.0046897540130225,0.0041670389266908,0.0036811633347419,0.0109484611329629,0.0041040857811732,0.0044494640991281,1.1317254174397031
9320900420,89000.0,3,1.0,900,4750,1.0,0,0,4,6,900,0,98023,47.3026,-122.363,900,3404,3850,2504,51,0,-1346,492,269000.0,0.0009152619937457,0.0009197075910728,0.0010677663869514,0.0,0.0009280340526628,0.0007095518942159,0.3308550185873606
1806900502,649000.0,3,3.25,1720,936,2.0,0,0,3,8,1030,690,98112,47.6201,-122.309,1720,1527,-784,-193,16,0,591,268,917500.0,0.0025678847198915,0.0006993289132159,0.0019174134650825,0.0052024428862248,0.0028127509194588,0.0011624498993228,0.7073569482288828
5095600310,379500.0,3,2.25,2070,14196,2.0,0,0,3,7,2070,0,98059,47.4617,-122.07,1550,13860,12126,12310,31,-520,-336,465,435000.0,0.0018468785967291,0.0021175401867987,0.0019562628763679,0.0,0.0014168410295223,0.0023663438297584,0.8724137931034482
6021503708,334900.0,2,2.5,980,1013,3.0,0,0,3,8,980,0,98117,47.6844,-122.387,980,1023,33,43,12,0,10,548,545000.0,0.0010561505682736,0.000398733656545,0.0013398081613457,0.0,0.0011611649565155,0.0004021597907039,0.6144954128440367
1445500100,900000.0,5,2.25,2510,35691,1.0,0,0,3,9,2510,0,98005,47.6435,-122.154,3160,35037,33181,31877,53,650,-654,168,765475.0,0.0056234779082454,0.0106602796385701,0.0069162581665578,0.0,0.0073249714302933,0.0113543194505386,1.1757405532512493
7658600082,565000.0,2,2.5,1950,2457,3.0,0,0,3,8,1950,0,98144,47.5925,-122.302,1650,1639,507,-11,11,-300,-818,340,452500.0,0.0030000738479716,0.0017643802013131,0.0038751910270448,0.0,0.0027555708457264,0.0012284809709122,1.2486187845303869
9265410010,212000.0,3,1.75,1470,8350,1.0,0,0,3,7,1470,0,98001,47.2587,-122.253,1590,8182,6880,6592,30,120,-168,358,260000.0,0.0021517779248078,0.0015584263365465,0.0023780020253459,0.0,0.0024239430693522,0.0020405409752947,0.8153846153846154
3761100045,3000000.0,4,4.25,4850,12445,2.0,1,4,5,10,3850,1000,98034,47.7011,-122.244,3350,12210,7595,8860,31,-1500,-235,543,446000.0,0.0045163837641125,0.002345743121808,0.0042660225157344,0.0058347142156977,0.0032247351626084,0.0026482131826794,6.726457399103139
8024201795,397000.0,2,1.0,1000,7664,1.0,0,2,3,7,1000,0,98115,47.7001,-122.311,1570,6350,6664,4780,81,570,-1314,576,570000.0,0.0009468737542692,0.002441118060101,0.0012327644125569,0.0,0.00161129590269,0.002085768783169,0.6964912280701754
2594200375,427500.0,3,1.75,1240,7200,1.0,0,0,5,7,1240,0,98136,47.5142,-122.389,1640,7200,5960,5560,78,400,0,263,489950.0,0.0027303393547591,0.0045762227095051,0.0034869660583223,0.0,0.0037291372959206,0.0047583202865037,0.8725380140830697
2223059053,230000.0,2,1.0,800,17965,1.0,0,0,4,5,800,0,98058,47.4693,-122.161,1500,8925,17165,7425,78,700,-9040,451,335000.0,0.0008632484903942,0.0020350550552342,0.0009805339497623,0.0,0.0016801470464695,0.0014343997177808,0.6865671641791045
9274200365,920000.0,4,2.75,2880,5750,1.5,0,0,5,9,1710,1170,98116,47.5874,-122.387,1640,5750,2870,4110,92,-1240,0,329,565500.0,0.0047190525191219,0.0035099306620827,0.0036604004606539,0.0081743869209809,0.002941551022458,0.0035471865258731,1.6268788682581783
2329720040,515000.0,3,2.5,2600,4506,2.0,0,0,3,8,2600,0,98028,47.7353,-122.222,2600,4658,1906,2058,17,0,152,282,442500.0,0.004340777767204,0.0013426102357195,0.0051742220258671,0.0,0.0044091112588351,0.0016336975190454,1.1638418079096045
3388000040,260000.0,5,1.0,1600,7350,1.0,0,0,5,7,1600,0,98031,47.3943,-122.196,1600,7725,5750,6125,58,0,375,271,288400.0,0.0030554993258804,0.0022343257488867,0.0034550817774668,0.0,0.0030889998783706,0.0033581203915503,0.9015256588072122
5029451230,198000.0,3,1.5,1430,7347,1.0,0,0,3,7,820,610,98023,47.2927,-122.369,1430,8723,5917,7293,40,0,1376,492,269000.0,0.0014542496122848,0.0014225456150762,0.0009728538192224,0.0043433681752157,0.0014745429947865,0.0018182788405538,0.7360594795539034
9521100585,499950.0,3,1.0,1830,3000,1.5,0,0,3,7,1430,400,98103,47.6619,-122.351,1510,2500,1170,990,94,-320,-500,599,550000.0,0.0018503351836685,0.0014394226187991,0.0016990899769137,0.0027140172204392,0.0016543594013629,0.0012022837620516,0.909
408100150,267800.0,2,1.0,700,6000,1.0,0,0,4,6,700,0,98155,47.7515,-122.316,920,6000,5300,5080,71,220,0,442,377225.0,0.0008887308922858,0.0013174510221114,0.0010747240262232,0.0,0.0012108083066714,0.0013812393169771,0.7099211346013652
3585210200,366000.0,3,1.75,1510,8301,1.0,0,0,3,7,1510,0,98034,47.7243,-122.222,1460,7910,6791,6450,53,-50,-391,543,446000.0,0.0014061318523319,0.001564645532674,0.0016731672724049,0.0,0.0014054069663905,0.001715591013513,0.820627802690583
4449800681,450000.0,4,1.75,2160,4333,1.0,0,0,4,8,1260,900,98117,47.6893,-122.388,1670,4426,2173,2756,78,-490,93,548,545000.0,0.002327842068848,0.0017055409020827,0.0017226104931587,0.0045813184016289,0.0019787198748785,0.0017399405998588,0.8256880733944955
1837010040,569500.0,4,2.5,2800,8190,1.0,0,0,3,8,1700,1100,98177,47.7695,-122.368,2460,8165,5390,5705,49,-340,-25,254,557000.0,0.0047402993160425,0.0027047949177597,0.0036395399621487,0.0089005405055507,0.004430037817396,0.0027464691137431,1.0224416517055654
8097000250,323400.0,4,3.0,2060,9138,1.0,0,0,3,8,1430,630,98092,47.321,-122.185,2250,7820,7078,5570,28,190,-1318,351,309780.0,0.0026729745405662,0.0008011841182126,0.0019730478898735,0.0137225005445436,0.0030094778489054,0.0007374525559615,1.0439666860352508
1423400260,273000.0,3,1.75,2050,9045,2.0,0,0,4,6,2050,0,98058,47.4572,-122.18,1200,9045,6995,7845,61,-850,0,451,335000.0,0.0022120742566351,0.0010246074575337,0.002512618246266,0.0,0.0013441176371756,0.0014536857644064,0.8149253731343283
2115510300,246000.0,3,2.25,1440,10500,1.0,0,0,3,8,1130,310,98023,47.318,-122.391,1510,8125,9060,6615,37,70,-2375,492,269000.0,0.0014644191899931,0.0020330378328978,0.0013406400191723,0.0022072854660932,0.0015570349105787,0.0016936278321105,0.9144981412639404
1726600150,970000.0,4,3.0,3510,12410,2.0,0,0,4,9,3510,0,98005,47.6381,-122.166,3000,13209,8900,10209,44,-510,799,168,765475.0,0.0078639073537615,0.00370665070507,0.0096717395078159,0.0,0.0069540868009114,0.0042805949602467,1.2671870407263464
7299601630,310000.0,3,2.5,2242,5744,2.0,0,0,3,8,2242,0,98092,47.2597,-122.199,2009,5712,3502,3703,8,-233,-32,351,309780.0,0.0029091305436648,0.0005036114658583,0.0030934079504171,0.0,0.0026871293326449,0.0005386609973979,1.0007101814190715
9265880170,550000.0,4,2.5,2470,5954,2.0,0,0,3,8,2470,0,98028,47.7685,-122.236,2470,4800,3484,2330,7,0,-1154,282,442500.0,0.0041237388788438,0.0017740571112903,0.0049155109245737,0.0,0.0041886556958934,0.0016835010930481,1.2429378531073447
2427910040,515000.0,4,2.5,2890,15067,2.0,0,0,3,9,2890,0,98024,47.5666,-121.907,3090,15398,12177,12308,17,200,331,79,465000.0,0.0153932195264853,0.0018378570247989,0.016527507720462,0.0,0.0183017839797199,0.0024359641841442,1.10752688172043
4338800600,235000.0,3,1.0,1590,13000,1.5,0,0,3,6,1590,0,98166,47.4789,-122.346,1460,8400,11410,6940,76,-130,-4600,250,392500.0,0.0030629464388913,0.0038062122654311,0.0037109648508612,0.0,0.0030897509152858,0.0026402167240756,0.5987261146496815
4364700600,390000.0,3,1.0,1010,7920,1.0,0,0,3,6,1010,0,98126,47.5249,-122.37,1520,7560,6910,6040,95,510,-360,352,396587.5,0.0018571536270578,0.0044114993081966,0.0022977366156842,0.0,0.0030576487485767,0.0042810182707744,0.9833895420304472
1402600040,330000.0,4,2.25,2430,7490,2.0,0,0,3,8,2430,0,98058,47.4406,-122.139,2070,7469,5060,5399,37,-360,-21,451,335000.0,0.0026221172895723,0.0008484588012081,0.0029783718724031,0.0,0.0023186029241279,0.0012003956853899,0.9850746268656716
2998300060,672500.0,2,1.75,1860,5940,1.0,0,2,5,8,1020,840,98116,47.5751,-122.407,2130,5940,4080,3810,64,270,0,329,565500.0,0.0030477214185996,0.0036259109796124,0.002183396766004,0.005868790609935,0.0038204290718509,0.0036643979067281,1.18921308576481
1524059027,675000.0,2,1.0,930,36478,1.0,0,2,3,6,930,0,98006,47.5699,-122.164,2800,11141,35548,8341,69,1870,-25337,490,760184.5,0.0006579082338276,0.0055432795371715,0.0008251110572866,0.0,0.0020529590104737,0.0018648450183396,0.8879423350515565
7611200125,467000.0,2,1.5,1320,10800,1.0,0,0,4,8,1320,0,98177,47.7145,-122.367,2120,12040,9480,9920,73,800,1240,254,557000.0,0.0022347125347057,0.0035667625289138,0.0028259957353155,0.0,0.0038177561678372,0.004049906690688,0.8384201077199281
1352300520,294000.0,3,3.0,1670,4120,1.5,0,0,3,7,1140,530,98055,47.4881,-122.199,1010,4120,2450,3110,91,-660,0,260,297225.0,0.0035915368766963,0.0015711194683819,0.0027627656738482,0.0101237775061124,0.0021742172279806,0.0020854181187402,0.989149634115569
7853361210,400000.0,3,2.0,1650,5027,1.5,0,0,3,7,1650,0,98065,47.515,-121.874,2430,6000,3377,3570,11,780,973,305,500000.0,0.0020951050726937,0.0009560603997386,0.0021950830140485,0.0,0.0031515261557217,0.0017377165882715,0.8
8126300610,436800.0,3,1.75,2080,12714,2.0,0,0,4,8,1540,540,98052,47.7056,-122.162,2080,12107,10634,10027,36,0,-607,571,615000.0,0.0015388963449732,0.0020028513142037,0.0012816159679362,0.0035997600159989,0.001559934872719,0.0021098002285631,0.7102439024390244
1442740010,465000.0,4,2.5,2590,16437,2.0,0,0,3,8,2590,0,98038,47.3714,-122.059,2320,15625,13847,13305,34,-270,-812,586,342750.0,0.0020546391212808,0.0011034262940504,0.0021479301914394,0.0,0.0018674151352386,0.0013323989628009,1.3566739606126914
8678500060,1550000.0,5,4.25,6070,171626,2.0,0,0,3,12,6070,0,98024,47.5954,-121.95,4680,211267,165556,206587,21,-1390,39641,79,465000.0,0.0323310873791579,0.0209347613817044,0.0347134850737733,0.0,0.027719206804236,0.0334224474147028,3.333333333333333
2591010040,468000.0,2,1.75,1250,7029,1.0,0,0,4,7,1250,0,98033,47.6936,-122.186,1680,8470,5779,6790,34,430,1441,431,678000.0,0.0012189069037911,0.001551985554545,0.0014091445590673,0.0,0.0017659635748989,0.0019791490687133,0.6902654867256637
5249802460,500000.0,3,1.0,1800,7200,1.0,0,0,3,7,1020,780,98118,47.5616,-122.275,1740,5475,5400,3735,56,-60,-1725,498,370000.0,0.0021306641635308,0.002498228686466,0.0015355317531406,0.0043203243566593,0.0021664776186675,0.0019779395613923,1.351351351351351
6977000040,625000.0,4,3.0,2190,12825,1.0,0,0,3,9,1520,670,98034,47.7107,-122.229,3050,4673,10635,1623,31,860,-8152,543,446000.0,0.0020393567924549,0.0024173688659854,0.0016842478503678,0.0039092585245174,0.0029359529092405,0.0010135217201196,1.4013452914798206
7974200457,935000.0,5,3.0,2700,5001,2.0,0,0,3,10,2700,0,98115,47.6811,-122.288,1610,5191,2301,3581,11,-1090,190,576,570000.0,0.0025565591365268,0.001592905978414,0.0033284639139037,0.0,0.0016523480275993,0.0017050749218,1.6403508771929824
1450000210,179500.0,3,1.0,900,8100,1.0,0,0,4,6,900,0,98002,47.2866,-122.221,1000,7830,7200,6830,61,100,-270,197,235000.0,0.0028072276755219,0.0054754813353685,0.0030033537450152,0.0,0.003433393875512,0.0052382465588466,0.7638297872340426
2771101921,377000.0,2,1.5,1000,1251,2.0,0,0,3,7,930,70,98199,47.6529,-122.384,1420,1187,251,-233,14,420,-64,316,689900.0,0.0014635502802698,0.0007277690127473,0.0018492374381101,0.0003881126635617,0.0022554719019028,0.0007111429571085,0.5464560081171185
9527300200,465000.0,4,2.75,2190,3267,2.0,0,0,3,8,2190,0,98072,47.7751,-122.168,2190,3619,1077,1429,16,0,352,272,517500.0,0.0033979987494123,0.0003900199307705,0.0038661773039503,0.0,0.0034169631155214,0.0005546451956599,0.8985507246376812
5249803550,635000.0,3,2.5,1960,7200,1.0,0,0,4,8,980,980,98118,47.5655,-122.27,1440,7200,5240,5760,80,-520,0,498,370000.0,0.0023200565336224,0.002498228686466,0.0014753148216449,0.0054280998327259,0.0017929469947593,0.0026011259985433,1.7162162162162162
1025069192,929000.0,4,3.25,4030,57499,2.0,0,0,3,9,4030,0,98053,47.6617,-122.026,3470,57499,53469,54029,18,-560,0,400,635000.0,0.0038451776891913,0.004079194215304,0.0039617548116151,0.0,0.0035064141105379,0.0049489977545791,1.462992125984252
686400380,770000.0,7,2.25,3260,8145,2.0,0,0,5,8,3260,0,98008,47.6336,-122.115,2340,8145,4885,5805,53,-920,0,283,545000.0,0.0053994517734549,0.0028248577773415,0.0067243669606686,0.0,0.00409105213469,0.0030311668708533,1.4128440366972477
59000250,720000.0,3,1.5,2180,5000,1.0,0,3,4,8,1090,1090,98116,47.5787,-122.402,2070,5000,2820,2930,79,-110,0,329,565500.0,0.0035720605873909,0.0030521136192024,0.0023332377205337,0.0076154544819394,0.0037128113515171,0.0030845100224984,1.273209549071618
6850700670,799200.0,6,3.0,2890,2370,2.5,0,0,3,7,2290,600,98102,47.6227,-122.323,2180,2460,-520,280,114,-710,90,104,710000.0,0.0129185683186639,0.006321078797448,0.0125648819778989,0.0144735255095887,0.0107249157503751,0.0071602379760393,1.1256338028169015
2372800100,245000.0,3,1.5,1550,9126,1.0,0,0,5,7,1550,0,98022,47.2012,-122.0,1450,9282,7576,7832,63,-100,156,233,280000.0,0.0036207001266077,0.0005276211340304,0.0038501281720088,0.0,0.0034543548694492,0.0007737061927003,0.875
7749500370,225000.0,4,2.25,1800,9350,1.0,0,0,3,8,1800,0,98092,47.2959,-122.191,2060,8800,7550,6740,51,260,-550,351,309780.0,0.002335608821854,0.0008197714494734,0.0024835567844562,0.0,0.0027553441638868,0.0008298698839464,0.726321905868681
7896300150,280000.0,3,1.75,1670,6034,1.0,0,0,3,7,990,680,98118,47.5209,-122.286,1230,6034,4364,4804,63,-440,0,498,370000.0,0.0019767828628313,0.0020936544297411,0.0014903690545189,0.0037664366186261,0.0015314755580236,0.0021798880937792,0.7567567567567568
9430110120,737000.0,3,2.5,2300,7800,2.0,0,2,3,9,2300,0,98052,47.6842,-122.155,2300,8187,5500,5887,23,0,387,571,615000.0,0.0017016642276146,0.0012287431375483,0.0019141017702944,0.0,0.0017249279842566,0.0014266898877712,1.1983739837398375
7202380340,449000.0,3,2.5,1690,3827,2.0,0,0,3,7,1690,0,98053,47.6768,-122.029,1690,3129,2137,1439,15,0,-698,400,635000.0,0.0016124938696608,0.0002715017002377,0.0016613810500321,0.0,0.0017077348261697,0.0002693162311358,0.7070866141732284
629410190,712000.0,3,2.75,3200,6699,2.0,0,0,3,9,3200,0,98075,47.5884,-121.991,3020,6699,3499,3679,16,-180,0,358,739999.5,0.0029600659354687,0.0009839233764713,0.0031521596726482,0.0,0.0028281999631022,0.0012428442301898,0.9621628122721704
8058500005,290000.0,2,1.0,1620,5400,1.0,0,0,3,6,920,700,98125,47.7069,-122.299,1540,7245,3780,5705,94,-80,1845,402,425000.0,0.0023003260215151,0.001746045449563,0.0016075119733432,0.0053056429302307,0.0023082987837963,0.0024614157370249,0.6823529411764706
6911700066,175000.0,2,1.0,670,2378,1.0,0,0,3,5,670,0,98126,47.5769,-122.372,700,2970,1708,2270,101,30,592,352,396587.5,0.0012319731981472,0.0013245638074358,0.0015242411212954,0.0,0.0014081277131603,0.0016818286063756,0.4412645380905853
4399200075,250000.0,3,1.75,1770,8868,1.0,0,0,4,7,1770,0,98002,47.3188,-122.212,1630,9706,7098,8076,61,-140,838,197,235000.0,0.005520881095193,0.0059946380842034,0.00590659569853,0.0,0.0055964320170845,0.0064932849425498,1.0638297872340423
2322069114,287653.0,3,1.0,1050,16050,1.0,0,0,4,7,1050,0,98038,47.3841,-122.006,1610,27600,15000,25990,60,560,11550,586,342750.0,0.0008329618059246,0.0010774467372093,0.000870782510043,0.0,0.0012959217102302,0.0023535495278916,0.8392501823486507
3204800040,431000.0,3,1.75,1660,12865,1.0,0,0,5,7,1660,0,98056,47.5375,-122.175,1610,12400,11205,10790,53,-50,-465,404,380000.0,0.0020377074073119,0.0033246502204373,0.002298417691724,0.0,0.0020873443405093,0.0039187541142967,1.1342105263157896
3819750170,415000.0,3,2.75,2080,9600,1.0,0,0,3,7,2080,0,98028,47.7698,-122.238,2220,9600,7520,7380,32,140,0,282,442500.0,0.0034726222137632,0.0028604212745024,0.0041393776206937,0.0,0.0037647026902361,0.0033670021860963,0.9378531073446328
8644210110,792000.0,3,2.5,3320,12840,1.0,0,0,3,10,2600,720,98075,47.5783,-121.994,3230,14933,9520,11703,30,-90,2093,358,739999.5,0.0030710684080487,0.001885889857276,0.0025611297340266,0.0109289617486338,0.0030248628744438,0.0027704721435176,1.070270993426347
11520030,640000.0,4,2.5,2341,9594,2.0,0,0,3,9,2341,0,98052,47.6993,-122.115,2850,9421,7253,6571,23,509,-173,571,615000.0,0.0017319982421068,0.0015113540591844,0.0019482227148953,0.0,0.0021374107631006,0.001641730234847,1.0406504065040652
4027700799,364000.0,3,2.25,1420,6600,1.0,0,0,3,7,1160,260,98028,47.77,-122.265,1920,7902,5180,5982,33,500,1302,282,442500.0,0.0023707324728576,0.0019665396262204,0.0023084990576945,0.0026948590381426,0.0032559590834475,0.0027714636744305,0.8225988700564971
1140000050,215000.0,3,1.75,1280,10016,1.0,0,0,4,7,1280,0,98003,47.2823,-122.333,1670,9764,8736,8094,45,390,-252,276,269500.0,0.0024011540546675,0.0034154715130716,0.0027881000405145,0.0,0.0032177573965067,0.0036203806219905,0.7977736549165121
3832710450,262500.0,4,2.75,1500,7036,1.0,0,0,3,7,1060,440,98032,47.3665,-122.276,1620,7200,5536,5580,41,120,164,123,250000.0,0.0069862975417547,0.0055024849553646,0.0059975104673531,0.0115893167570984,0.0078851685819838,0.0062997031264901,1.05
1180005220,225000.0,2,1.0,1070,6000,1.0,0,0,4,5,1070,0,98178,47.495,-122.227,1910,6000,4930,4090,98,840,0,258,279500.0,0.0023879664345652,0.0027990531736131,0.0031188970181012,0.0,0.0044853580067162,0.0028596688980027,0.8050089445438283
8943600020,260000.0,3,2.25,1413,3403,2.0,0,0,3,8,1413,0,98031,47.4196,-122.193,1763,3719,1990,1956,11,350,316,271,288400.0,0.0026983878421681,0.0010344776222396,0.0030512690947253,0.0,0.0034036917409796,0.0016166795774984,0.9015256588072122
423059360,345000.0,4,2.5,2040,5875,2.0,0,0,3,8,2040,0,98056,47.5051,-122.17,2230,5459,3835,3229,16,190,-416,404,380000.0,0.0025041705487447,0.0015182526269,0.0028245615006729,0.0,0.0028911663846807,0.0017251998959633,0.9078947368421052
3210950510,535000.0,3,1.0,1330,40259,1.0,0,0,4,7,1330,0,98024,47.552,-121.89,1710,34787,38929,33077,43,380,-5472,79,465000.0,0.0070840768063064,0.0049107510427676,0.0076060848678943,0.0,0.0101281717169324,0.0055033047196924,1.1505376344086022
7170200110,455000.0,3,1.75,890,3800,1.5,0,0,3,7,750,140,98115,47.6803,-122.291,1280,3800,2910,2520,94,390,0,576,570000.0,0.0008427176412996,0.0012103664703006,0.0009245733094177,0.0005716105535639,0.0013136679970976,0.0012481765946523,0.7982456140350878
255450390,351999.0,3,2.5,2370,4200,2.0,0,0,3,8,2370,0,98038,47.3706,-122.017,2370,4200,1830,1830,6,0,0,586,342750.0,0.0018801137905156,0.0002819486788958,0.0019654805226685,0.0,0.0019076611510843,0.0003581488412008,1.026984682713348
3543900380,395000.0,3,1.0,1460,5000,1.0,0,0,4,7,1460,0,98115,47.6837,-122.32,1790,4000,3540,2210,86,330,-1000,576,570000.0,0.001382435681233,0.0015925874609218,0.0017998360423331,0.0,0.0018370825896911,0.001313870099634,0.6929824561403509
7203220030,963990.0,4,3.25,3830,6765,2.0,0,0,3,9,3830,0,98053,47.685,-122.016,3830,6507,2935,2677,6,0,-258,400,635000.0,0.0036543500123083,0.0004799344139294,0.0037651416695994,0.0,0.0038701919433314,0.000560064147012,1.5180944881889764
1588600040,365000.0,2,1.0,770,5680,1.0,0,0,4,6,770,0,98117,47.6951,-122.366,1170,5514,4910,4344,91,400,-166,548,545000.0,0.0008298325893578,0.002235742516462,0.0010527064124859,0.0,0.0013862887746155,0.0021676530654364,0.6697247706422018
8724300030,355000.0,3,2.25,1860,5028,2.0,0,0,3,8,1860,0,98019,47.7318,-121.982,2320,5465,3168,3145,8,460,437,190,401250.0,0.0045080417648256,0.0006642628314163,0.0048076177478637,0.0,0.0058042516143074,0.0007770359087274,0.8847352024922118
9510400100,345000.0,4,2.5,2331,3826,2.0,0,0,3,8,2331,0,98058,47.4444,-122.182,2441,3826,1495,1385,13,110,0,451,335000.0,0.0025152902888861,0.000433404989776,0.00285703079612,0.0,0.0027341592936213,0.000614903453247,1.0298507462686568
8562770050,627000.0,3,3.5,2710,3475,2.0,0,0,3,8,1650,1060,98027,47.5359,-122.072,2440,2867,765,427,15,-270,-608,411,571000.0,0.002620689521787,0.000256763235997,0.0018985834266324,0.0064238530998121,0.0024976993527478,0.0002447838708688,1.0980735551663747
6031400094,347500.0,5,3.0,2230,6551,1.0,0,0,3,7,1330,900,98168,47.487,-122.32,2230,9476,4321,7246,6,0,2925,264,237000.0,0.0057242600816284,0.0021860793695975,0.0040631778327681,0.0144601542416452,0.0057204128958115,0.0036733651179946,1.4662447257383966
984210120,359900.0,5,2.25,2290,7420,1.0,0,0,3,7,1290,1000,98058,47.4375,-122.166,1660,7526,5130,5866,47,-630,106,451,335000.0,0.0024710488037534,0.0008405292797015,0.0015811109939917,0.009021199819576,0.0018593627314262,0.0012095565575371,1.0743283582089551
8016250060,255000.0,3,2.5,1610,6176,2.0,0,0,3,7,1610,0,98030,47.3657,-122.173,1680,7414,4566,5734,26,70,1238,253,283000.0,0.0032300778428697,0.0020682952705829,0.0035162051192452,0.0,0.0034499753573188,0.0034169693500522,0.901060070671378
4189800020,367500.0,3,1.0,1570,10050,1.0,0,0,3,7,1570,0,98028,47.736,-122.231,2540,9940,8480,7400,57,970,-110,282,442500.0,0.002621161959427,0.0029945035217447,0.0031244340694659,0.0,0.0043073625374774,0.0034862501801872,0.8305084745762712
7016100120,440000.0,3,2.75,1560,7392,1.0,0,0,5,7,1030,530,98011,47.7382,-122.182,1870,7520,5832,5650,48,310,128,194,470000.0,0.0035640524189863,0.0033615570120887,0.0027096064756964,0.0092053842813721,0.0042837344084666,0.0040729954444195,0.9361702127659576
2206700215,550000.0,4,2.0,2070,9822,1.0,0,0,5,7,2070,0,98006,47.566,-122.14,1300,9572,7752,8272,65,-770,-250,490,760184.5,0.0014643763914228,0.0014925733761198,0.0018365375146057,0.0,0.0009531595405771,0.0016022167234132,0.7235085693012683
3298700110,373000.0,3,2.5,2990,6771,1.0,0,0,3,7,1550,1440,98106,47.5237,-122.353,1800,6771,3781,4971,17,-1190,0,330,315000.0,0.0060758649979374,0.0037073072443882,0.0039418037185196,0.0145616341389422,0.0040012270429598,0.0040243063108683,1.184126984126984
3066200440,684680.0,4,2.25,2370,9360,2.0,0,0,4,8,2370,0,98052,47.6518,-122.123,2370,9720,6990,7350,41,0,360,571,615000.0,0.001753454008455,0.001474491765058,0.0019723570415643,0.0,0.0017774257924731,0.0016938348246166,1.11330081300813
1545805030,266500.0,3,2.25,1740,5460,1.0,0,0,3,7,1210,530,98038,47.3648,-122.046,1740,7500,3720,5760,22,0,2040,586,342750.0,0.0013803367069608,0.0003665332825646,0.00100347317824,0.0096803652968036,0.001400561351429,0.0006395515021444,0.7775346462436178
3013300055,405000.0,2,1.75,1710,4234,2.0,0,0,3,7,1330,380,98136,47.5319,-122.386,1530,4556,2524,3026,100,-180,322,263,489950.0,0.0037652260456759,0.002691073187784,0.0037400523044908,0.0038560672173401,0.0034790122333894,0.0030109593368487,0.8266149607102765
3654200039,390500.0,3,2.25,1530,1279,2.0,0,0,3,7,1116,414,98177,47.7035,-122.357,1320,1427,-251,107,13,-210,148,254,557000.0,0.0025902349834089,0.0004223971550445,0.0023892509398576,0.0033498397902709,0.0023770934629929,0.0004800013993033,0.7010771992818672
1072100085,310000.0,3,1.0,1480,7830,1.0,0,0,3,7,1480,0,98133,47.7703,-122.336,1450,7830,6350,6380,68,-30,0,484,375000.0,0.0018954966585467,0.0022796458775384,0.0022391875985318,0.0,0.0019323516986704,0.0024061338898273,0.8266666666666667
123039604,102500.0,2,1.0,820,4320,1.0,0,0,3,5,820,0,98106,47.514,-122.359,780,7424,3500,6644,83,-40,3104,330,315000.0,0.0016662907352203,0.0023653178697027,0.0020853413220555,0.0,0.0017338650519492,0.004412413240568,0.3253968253968254
5075400150,585000.0,3,2.0,1670,4572,1.5,0,0,3,8,1670,0,98117,47.6854,-122.373,1480,4890,2902,3410,89,-190,318,548,545000.0,0.0017997667847112,0.0017996152790958,0.0022831424790279,0.0,0.0017535960567785,0.0019223473866493,1.073394495412844
1370802770,849000.0,3,1.75,2520,4534,1.0,0,0,5,9,1460,1060,98199,47.6381,-122.401,1870,5023,2014,3153,66,-650,489,316,689900.0,0.00368814670628,0.0026376536401249,0.0029031039350977,0.0058771346196495,0.0029702341243368,0.0030093269364416,1.23061313233802
1070000390,1054690.0,4,3.5,3390,3979,2.0,0,0,3,9,2610,780,98199,47.6482,-122.408,3350,4165,589,815,6,-40,186,316,689900.0,0.0049614354501148,0.0023147824953809,0.0051897953908253,0.0043246839654025,0.0053210076558975,0.0024952909994584,1.5287577909842005
8835700250,965000.0,4,2.5,3570,17411,2.0,0,0,3,10,3570,0,98075,47.5617,-122.03,3510,16153,13841,12643,30,-60,-1258,358,739999.5,0.0033023235592572,0.00255726077142,0.0035166281347981,0.0,0.0032870800895659,0.0029968148753927,1.3040549351722537
9282800075,339000.0,4,2.5,1740,6000,1.0,0,0,4,7,1740,0,98178,47.5026,-122.236,1190,6000,4260,4810,68,-550,0,258,279500.0,0.0038832351365827,0.0027990531736131,0.0050718512256973,0.0,0.0027945424230326,0.0028596688980027,1.2128801431127012
6825100015,437000.0,2,1.75,1500,6800,1.0,0,0,4,7,910,590,98117,47.7004,-122.371,1450,6800,5300,5350,78,-50,0,548,545000.0,0.0016165569922556,0.0026765931535108,0.0012441075783924,0.0030033087299567,0.0017180501907628,0.0026732029098599,0.8018348623853211
1761100080,205000.0,3,1.75,1290,7210,1.0,0,0,3,7,1290,0,98023,47.2889,-122.363,1350,7509,5920,6159,36,60,299,492,269000.0,0.0013118755243688,0.0013960193119231,0.0015304651546303,0.0,0.0013920510789942,0.0015652247866237,0.7620817843866171
7974200777,531000.0,2,1.5,1260,6660,1.5,0,0,4,7,1260,0,98115,47.6792,-122.287,2140,4770,5400,2630,94,880,-1890,576,570000.0,0.0011930609303792,0.0021213264979479,0.0015532831598217,0.0,0.0021962886826475,0.0015667900938136,0.9315789473684212
2212900470,186000.0,3,1.0,1200,10080,1.0,0,0,4,7,1200,0,98042,47.3261,-122.135,1230,9800,8880,8570,51,30,-280,546,292000.0,0.0011082604190332,0.0009716883934134,0.0011896406095718,0.0,0.0011510527453543,0.0012184720360667,0.636986301369863
8731983200,255000.0,2,1.75,1950,8200,1.0,0,0,3,8,1950,0,98023,47.3161,-122.382,2370,8000,6250,5630,45,420,-200,492,269000.0,0.0019830676531157,0.0015877057361678,0.0023134938383947,0.0,0.0024438230053454,0.0016675720193088,0.9479553903345724
3558900070,497000.0,3,2.25,1870,9315,1.0,0,0,3,7,1350,520,98034,47.705,-122.202,2230,9579,7445,7349,45,360,264,543,446000.0,0.0017413685853382,0.0017557731763472,0.0014958780249977,0.0030340513921628,0.0021466147500348,0.0020775785484755,1.1143497757847534
8045000340,565000.0,3,2.5,1700,7210,2.0,0,0,5,7,1700,0,98052,47.6688,-122.161,1700,7566,5510,5866,54,0,356,571,615000.0,0.0012577518204107,0.0011357997463748,0.0014147708736959,0.0,0.0012749467709723,0.0013184726628651,0.91869918699187
2314300420,400000.0,4,2.5,2150,5397,2.0,0,0,3,8,2150,0,98058,47.4644,-122.151,2260,5080,3247,2820,22,110,-317,451,335000.0,0.0023199803179344,0.0006113661081602,0.0026351849899862,0.0,0.002531421550014,0.0008164426404847,1.1940298507462686
8073000480,869000.0,2,1.75,1900,13122,1.0,1,4,3,7,1100,800,98178,47.5121,-122.248,1650,13160,11222,11510,66,-250,38,258,279500.0,0.0042403142296018,0.0061215292906919,0.0032063427288891,0.0076183220645652,0.0038747857126083,0.006272207116286,3.10912343470483
1450100390,208000.0,3,1.0,920,7314,1.0,0,0,3,6,920,0,98002,47.2892,-122.22,1010,7420,6394,6410,60,90,106,197,235000.0,0.0028696105127557,0.0049441568502327,0.0030700949393489,0.0,0.0034677278142671,0.0049639577862889,0.8851063829787233
6147650300,270000.0,3,2.25,2100,14027,2.0,0,0,3,8,2100,0,98042,47.3833,-122.1,2730,5999,11927,3269,41,630,-8028,546,292000.0,0.0019394557333082,0.0013521699498423,0.0020818710667507,0.0,0.0025547756055426,0.0007458789535065,0.9246575342465754
6600220550,495000.0,3,1.75,1440,11787,1.0,0,0,3,8,1440,0,98074,47.6276,-122.033,2190,11787,10347,9597,37,750,0,435,645000.0,0.0012483431279144,0.0018572643427463,0.0013532702621679,0.0,0.0019439002805784,0.0020506412886106,0.7674418604651163
2155500030,380000.0,4,1.75,1720,9600,1.0,0,0,4,8,1720,0,98059,47.4764,-122.155,1660,10720,7880,9060,51,-60,1120,465,435000.0,0.0015346044378619,0.0014319798389171,0.0016254937909917,0.0,0.0015173910380691,0.0018302457326847,0.8735632183908046
8044200200,401000.0,2,1.5,1260,2625,2.0,0,0,4,7,1260,0,98052,47.6747,-122.151,1260,2625,1365,1365,37,0,0,571,615000.0,0.000932216055128,0.0004135193251364,0.0010485948828569,0.0,0.0009449605478971,0.0004574399603517,0.6520325203252032
1003600056,239000.0,4,2.0,1370,8837,1.5,0,0,3,7,1370,0,98188,47.4386,-122.285,1360,9000,7467,7640,65,-10,163,135,265000.0,0.0056187378756249,0.0064576852446605,0.0067962080135725,0.0,0.0061473372085664,0.0068301812047073,0.9018867924528302
136000220,593000.0,2,2.5,2000,2500,3.0,0,1,3,8,1810,190,98116,47.5788,-122.396,1970,5650,500,3680,26,-30,3150,329,565500.0,0.0032771198049458,0.0015260568096012,0.0038744589671248,0.0013274645427233,0.003533448484294,0.0034854963254232,1.0486295313881522
1254200015,625000.0,3,2.5,2260,5500,1.5,0,0,3,7,1280,980,98117,47.681,-122.388,1790,5355,3240,3565,110,-470,-145,548,545000.0,0.0024356125349984,0.002164891521222,0.0017499535168597,0.0049885467039959,0.0021209033389416,0.0021051472915147,1.146788990825688
2425049063,3640900.0,4,3.25,4830,22257,2.0,1,4,4,11,4830,0,98039,47.6409,-122.241,3820,25582,17427,21762,30,-1010,3325,49,1905000.0,0.0255792400370713,0.0258184184609174,0.029572937394765,0.0,0.0246929541047188,0.0298702997071585,1.9112335958005249
2021069059,254600.0,3,2.0,1470,20000,1.0,0,0,4,7,1470,0,98002,47.2973,-122.08,1390,30056,18530,28666,52,-80,10056,197,235000.0,0.0045851385366857,0.0135197070009098,0.0049054777835249,0.0,0.0047724174869616,0.0201073740195012,1.083404255319149
9542000030,835100.0,4,2.5,2380,12573,1.0,0,0,4,9,2380,0,98005,47.5984,-122.176,2900,10700,10193,7800,57,520,-1873,168,765475.0,0.0053322220803283,0.0037553359641294,0.0065580455921942,0.0,0.0067222839075477,0.003467512005045,1.0909565955779092
4174600391,393000.0,5,2.0,1820,5054,1.0,0,0,4,7,910,910,98108,47.5547,-122.299,1180,5628,3234,4448,50,-640,574,185,345000.0,0.0057680727664564,0.0052361607980016,0.0037866178428761,0.0120994548597261,0.0040593071657091,0.0060149861648905,1.1391304347826088
2770601782,453000.0,3,2.5,1510,1618,2.5,0,0,3,8,1330,180,98199,47.6515,-122.384,1350,1397,108,47,9,-160,-221,316,689900.0,0.0022099609232075,0.0009412711931455,0.0026446083792328,0.0009980039920159,0.002144286667302,0.0008369559486778,0.6566169010001449
8732900840,667000.0,3,2.5,2510,3819,2.0,0,0,3,8,2510,0,98052,47.6987,-122.096,2520,3990,1309,1470,13,10,171,571,615000.0,0.0018570335701359,0.0006016115438842,0.0020888675841039,0.0,0.0018899210957942,0.0006953087397346,1.0845528455284552
9542830430,300000.0,3,2.5,1880,4200,2.0,0,0,3,7,1880,0,98038,47.366,-122.017,2090,4200,2320,2110,13,210,0,586,342750.0,0.0014913982810841,0.0002819486788958,0.0015591153513151,0.0,0.0016822834623486,0.0003581488412008,0.87527352297593
7300200290,650000.0,5,3.5,3480,36615,2.0,0,0,4,8,2490,990,98075,47.5741,-122.05,2540,35910,33135,33370,37,-940,-705,358,739999.5,0.0032190717048222,0.0053778704925359,0.0024527742452793,0.0150273224043715,0.0023786847371787,0.0066622684439642,0.8783789718776837
1705400055,519000.0,4,1.0,1640,6305,1.5,0,0,5,6,1640,0,98118,47.5563,-122.28,1590,4816,4665,3226,113,-50,-1489,498,370000.0,0.0019412717934392,0.00218768498169,0.0024688941913242,0.0,0.0019797123067134,0.0017398642790256,1.4027027027027028
2320069014,495000.0,3,2.0,2660,192099,1.0,0,0,4,9,2660,0,98022,47.2098,-122.016,2570,43561,189439,40991,56,-90,-148538,233,280000.0,0.0062135886043719,0.0111062340813188,0.006607316733899,0.0,0.0061225462168858,0.003631051008427,1.7678571428571428
2325069054,225000.0,2,1.0,1396,111949,1.0,0,0,3,7,1396,0,98053,47.6374,-122.007,2020,111949,110553,109929,80,624,0,400,635000.0,0.0013319771846429,0.0079420809615658,0.0013723597312691,0.0,0.0020411978395638,0.0096355649598668,0.3543307086614173
3798000165,444950.0,3,1.0,1760,6927,1.0,0,0,3,7,1050,710,98011,47.7623,-122.2,2060,9120,5167,7060,58,300,2193,194,470000.0,0.0040209822162922,0.0031500954305653,0.002762220193671,0.0123317412071211,0.0047189801505033,0.004939590219828,0.9467021276595744
5153200150,345000.0,2,1.0,1770,16660,1.0,0,3,3,8,1220,550,98023,47.3346,-122.354,2790,20504,14890,17714,63,1020,3844,492,269000.0,0.0018000152543665,0.0032257533615312,0.0014474166578674,0.0039161516333912,0.0028769055632548,0.0042739870854884,1.2825278810408922
7853360990,430000.0,3,2.5,1950,4949,2.0,0,0,3,7,1950,0,98065,47.5155,-121.87,2200,5740,2999,3540,11,250,791,305,500000.0,0.002476033267729,0.0009412259634585,0.0025941890166028,0.0,0.0028532335566204,0.001662415536113,0.86
5562100325,305000.0,2,1.0,1000,8212,1.0,0,0,4,7,1000,0,98133,47.7444,-122.341,1620,8214,7212,6594,73,620,2,484,375000.0,0.0012807409855045,0.0023908623175409,0.0015129645936025,0.0,0.0021589032771352,0.0025241358583705,0.8133333333333334
1310430400,455000.0,4,2.5,3360,7685,2.0,0,0,3,9,3360,0,98058,47.4369,-122.111,3060,6567,4325,3507,19,-300,-1118,451,335000.0,0.0036256436596556,0.000870548182548,0.0041182425890018,0.0,0.0034274999747977,0.0010554289015873,1.3582089552238803
7857000716,334998.0,2,1.0,1800,5182,1.0,0,0,3,6,900,900,98108,47.5508,-122.3,1570,5876,3382,4306,78,-230,694,185,345000.0,0.0057046873514404,0.0053687742887306,0.0037450066577896,0.0119664938173115,0.0054009425848842,0.0062800388601451,0.971008695652174
8731951670,270000.0,4,2.25,1900,8600,1.0,0,0,4,8,1900,0,98023,47.3102,-122.381,2120,8000,6700,5880,45,220,-600,492,269000.0,0.0019322197645742,0.0016651547964687,0.0022541734835641,0.0,0.0021860357684946,0.0016675720193088,1.003717472118959
2806300065,1960000.0,4,4.0,4430,31353,2.0,0,0,3,12,4430,0,98005,47.6422,-122.157,3900,35237,26923,31337,22,-530,3884,168,765475.0,0.0099251024436363,0.0093645946459357,0.0122067823417733,0.0,0.0090403128411848,0.0114191327590442,2.5605016493027204
4058801325,319950.0,2,1.0,1070,5824,1.0,0,2,5,7,1070,0,98178,47.507,-122.242,2090,7980,4754,5890,71,1020,2156,258,279500.0,0.0023879664345652,0.0027169476138538,0.0031188970181012,0.0,0.0049080619026372,0.0038033596343436,1.1447227191413238
2473480780,320000.0,3,2.25,1880,7350,1.0,0,0,3,8,1390,490,98058,47.4457,-122.123,1910,8400,5470,6490,36,30,1050,451,335000.0,0.0020286339524263,0.0008325997581949,0.001703677737712,0.0044203879115922,0.0021393872391711,0.0013500232637937,0.9552238805970148
4358700100,465000.0,3,2.5,1450,5175,1.0,0,0,3,8,1030,420,98133,47.7082,-122.338,1740,9250,3725,7510,25,290,4075,484,375000.0,0.0018570744289816,0.0015066625052696,0.0015583535314106,0.0035045559226995,0.0023188220384044,0.0028424953360029,1.24
3876100310,405000.0,3,1.5,1600,7500,1.0,0,0,3,7,1600,0,98034,47.721,-122.182,1700,7500,5900,5800,54,100,0,543,446000.0,0.0014899410355835,0.0014136660035002,0.0017728924740714,0.0,0.0016364327690848,0.0016266665741274,0.9080717488789236
3362401611,1165000.0,4,3.75,3920,4500,3.0,0,0,3,8,3920,0,98103,47.6805,-122.346,2040,3000,580,960,7,-1880,-1500,599,550000.0,0.003963559519115,0.0021591339281987,0.0046576452513999,0.0,0.0022350285952187,0.001442740514462,2.118181818181818
3332000615,389000.0,3,1.0,1330,3740,1.5,0,0,3,6,1330,0,98118,47.5502,-122.274,1330,5053,2410,3723,117,0,1313,498,370000.0,0.0015743240763866,0.0012976910121365,0.0020022129722324,0.0,0.001655985765993,0.0018254846764777,1.0513513513513513
6865200444,531000.0,2,3.0,1270,1175,2.0,0,0,3,8,1110,160,98103,47.6634,-122.34,1290,1800,-95,510,20,20,625,599,550000.0,0.0012841123952235,0.0005637738590296,0.0013188740380239,0.0010856068881757,0.0014133269058001,0.0008656443086772,0.9654545454545456
2024059059,693000.0,3,2.25,2090,45535,1.0,0,2,5,8,1280,810,98006,47.5538,-122.191,3090,12889,43445,9799,68,1000,-32646,490,760184.5,0.0014785249555911,0.0069196017798428,0.0011356367240074,0.0028277186245418,0.0022655869079871,0.0021574353685826,0.911620797319598
8100400170,500000.0,3,2.0,2050,11454,1.0,0,0,3,8,2050,0,98052,47.6389,-122.11,1980,11424,9404,9444,33,-70,-30,571,615000.0,0.001516700724613,0.0018043620381382,0.001706047230045,0.0,0.0014849380038383,0.0019907787074506,0.8130081300813008
7856620210,812500.0,4,2.75,2810,10300,1.0,0,0,4,9,1810,1000,98006,47.5626,-122.149,2710,9900,7490,7190,42,-100,-400,490,760184.5,0.0019878732656513,0.0015652113392419,0.0016058613050417,0.0034910106475824,0.0019869710422799,0.0016571192605297,1.0688194773768736
8161010060,504750.0,3,2.5,2490,21937,2.0,0,0,3,8,2490,0,98014,47.6442,-121.898,2450,21937,19447,19487,27,-40,0,123,415000.0,0.0095553133682287,0.0018289712988989,0.0102083487073524,0.0,0.0103468081152761,0.002273808077621,1.216265060240964
8080400177,520000.0,2,1.75,1340,1368,2.0,0,0,3,7,1060,280,98122,47.618,-122.311,2480,1707,28,-773,14,1140,339,289,574000.0,0.0025920567002731,0.0013508429437711,0.0024527158042825,0.0033022762118174,0.0050131595438024,0.0016602232110292,0.9059233449477352
8651100110,1275000.0,4,2.5,2720,16454,1.0,0,1,5,9,1870,850,98040,47.5489,-122.216,3560,15993,13734,12433,57,840,-461,282,993750.0,0.0031045727388837,0.004257555453146,0.0026800007452408,0.0047654822107352,0.0043550277327187,0.0044302405399281,1.2830188679245282
7237501180,1200000.0,4,1.75,3990,13470,2.0,0,0,3,11,3990,0,98059,47.5305,-122.131,5790,13709,9480,7919,14,1800,239,465,435000.0,0.0035599254110866,0.0020092467114806,0.0037707675732889,0.0,0.0052925868135062,0.002340563316173,2.7586206896551726
7696630080,197000.0,3,1.75,1690,7735,1.0,0,0,4,7,1060,630,98001,47.3324,-122.28,1580,7503,6045,5923,44,-110,-232,358,260000.0,0.0024738127162756,0.0014436440375074,0.0017147497597732,0.009693799046007,0.0024086981443877,0.0018712025100998,0.7576923076923077
2771604120,970000.0,4,1.75,4060,4000,2.0,0,3,3,10,2890,1170,98199,47.6375,-122.389,1860,4000,-60,2140,67,-2200,0,316,689900.0,0.0059420141378957,0.0023269992413982,0.0057465550496112,0.0064870259481037,0.0029543505193938,0.0023964379346539,1.4060008696912596
226059121,500000.0,3,2.75,1560,77536,1.0,0,0,3,7,1400,160,98072,47.7695,-122.126,2210,41449,75976,39239,42,650,-36087,272,517500.0,0.0024204922598553,0.0092563775182818,0.0024715288701052,0.0020500730338518,0.0034481682581289,0.0063524423086236,0.966183574879227
3972900160,190000.0,4,2.0,1580,6250,1.0,0,0,3,7,860,720,98155,47.7659,-122.31,1580,6250,4670,4670,43,0,0,442,377225.0,0.0020059925854451,0.0013723448146994,0.0013203752322171,0.005282077617196,0.0020794316571096,0.0014387909551845,0.5036781761548148
8861000210,865000.0,3,1.75,1480,8163,1.0,0,0,3,7,1040,440,98004,47.638,-122.206,2170,11124,6683,8954,67,690,2961,315,1150000.0,0.0016141697932117,0.0019805521089252,0.001365169792993,0.0028374282582059,0.0025775644985033,0.0027592351531122,0.7521739130434782
7936000562,721000.0,3,2.25,2680,10440,1.0,0,1,3,8,1540,1140,98116,47.561,-122.398,2140,7560,7760,5420,57,-540,-2880,329,565500.0,0.0043913405386274,0.0063728132368946,0.0032965009996532,0.0079647872563403,0.0038383653585732,0.0046637791540176,1.2749778956675508
1125049140,1250000.0,3,2.5,2710,13120,1.0,0,0,3,10,2710,0,98105,47.6718,-122.256,3130,13566,10410,10436,61,420,446,229,675000.0,0.0055027391864068,0.011187408707931,0.0069881021758526,0.0,0.0067376306357697,0.0119943237830836,1.851851851851852
4180300050,400000.0,4,3.5,3350,9681,1.0,0,1,3,7,2140,1210,98198,47.3978,-122.322,2580,9681,6331,7101,40,-770,0,275,266750.0,0.0069629053813905,0.0033357544917772,0.005265864647593,0.0161916231767697,0.0054674917351869,0.0037048149199834,1.499531396438613
3904921070,590000.0,4,2.5,2340,8971,2.0,0,0,3,9,2340,0,98029,47.5679,-122.011,2510,9219,6631,6709,33,170,248,320,574500.0,0.0032053038189688,0.0032259410103369,0.0033707865168539,0.0,0.0035460491926027,0.0040857624540634,1.0269799825935595
9414610010,430000.0,3,2.0,1730,9000,1.0,0,0,3,8,1370,360,98027,47.5202,-122.047,2390,10000,7270,7610,42,660,1000,411,571000.0,0.0016729862998861,0.000664998309057,0.0015763995724159,0.0021816859584267,0.002446516988962,0.0008537979451303,0.7530647985989493
7526800100,695500.0,5,2.75,2510,9180,1.0,0,1,4,8,1600,910,98052,47.6389,-122.098,2650,9780,6670,7130,45,140,600,571,615000.0,0.0018570335701359,0.0014461361541915,0.0013315490575961,0.0060662622491833,0.0019874170253391,0.0017042905951389,1.1308943089430894
9828201745,615000.0,2,1.5,880,2400,1.5,0,0,3,7,880,0,98122,47.6144,-122.295,1220,4440,1520,3220,91,340,2040,289,574000.0,0.0017022461912241,0.0023698999013529,0.0020362168941213,0.0,0.0024661510659028,0.0043183310234152,1.0714285714285714
7135520610,950000.0,4,3.5,4140,13392,2.0,0,0,3,11,4140,0,98059,47.5261,-122.144,4140,11529,9252,7389,20,0,-1863,465,435000.0,0.0036937571934583,0.0019976118752894,0.0039125257527359,0.0,0.0037843366853049,0.0019683678220263,2.183908045977012
7533800885,1100000.0,3,2.25,2420,7200,1.0,0,0,3,8,1420,1000,98115,47.6867,-122.275,2500,7200,4780,4700,72,80,0,576,570000.0,0.0022914344853315,0.0022933259437275,0.0017505254658308,0.004082932525457,0.0025657578068312,0.0023649661793412,1.9298245614035088
7852010510,585000.0,4,2.5,2910,6250,2.0,0,0,3,8,2910,0,98065,47.538,-121.87,2550,6250,3340,3700,21,-360,0,305,500000.0,0.0036950034918417,0.0011886567532059,0.0038713282247765,0.0,0.0033071570769919,0.0018101214461161,1.17
3176100110,650000.0,3,1.5,1630,7475,1.0,0,1,3,7,1160,470,98115,47.6725,-122.272,2320,7475,5845,5155,80,690,0,576,570000.0,0.0015434042194588,0.0023809182540782,0.001430006718566,0.0019189782869648,0.0023810232447394,0.0024552947486911,1.1403508771929824
9276202160,660000.0,3,2.0,2080,5750,1.0,0,0,5,7,1040,1040,98116,47.5791,-122.392,1710,4830,3670,3120,94,-370,-920,329,565500.0,0.0034082045971436,0.0035099306620827,0.0022262084672982,0.0072661217075386,0.0030671050295141,0.0029796366817334,1.16710875331565
5347200160,235000.0,1,1.0,810,2451,1.0,0,0,5,7,810,0,98126,47.5188,-122.376,980,1198,1641,218,79,170,-1253,352,396587.5,0.001489400433581,0.0013652253540896,0.0018427392660437,0.0,0.0019713787984245,0.0006783941651306,0.5925552368645003
2817910220,465000.0,4,2.5,2820,39413,2.0,0,0,4,9,2820,0,98092,47.3064,-122.1,2910,39413,36593,36503,31,90,0,351,309780.0,0.0036591204875713,0.0034555777687802,0.0038909056289814,0.0,0.0038922580179177,0.0037167797427252,1.5010652721286073
6777800160,285000.0,4,1.75,2510,7440,1.0,0,2,4,8,1290,1220,98032,47.3748,-122.276,1790,8000,4930,6210,58,-720,560,123,250000.0,0.0116904045532029,0.0058184320733247,0.0072988570781939,0.032134014644682,0.0087126245442907,0.0069996701405446,1.14
3025079003,495500.0,3,2.5,2010,57934,1.0,0,0,3,7,2010,0,98014,47.6262,-121.96,2040,55527,55924,53487,42,30,-2407,123,415000.0,0.0077133252490521,0.0048301783849392,0.0082404742577423,0.0,0.008615301451087,0.0057554698056281,1.193975903614458
2426049168,447450.0,3,2.25,1570,7200,2.0,0,0,3,8,1570,0,98034,47.7332,-122.232,1620,7318,5630,5698,29,50,118,543,446000.0,0.0014620046411663,0.0013571193633602,0.0017396507401826,0.0,0.0015594241681867,0.0015871927985952,1.0032511210762332
7768800290,855000.0,4,3.5,2890,5911,2.0,0,0,3,9,2370,520,98075,47.5754,-122.071,3490,6093,3021,2603,6,600,182,358,739999.5,0.0026733095479701,0.0008681849646696,0.002334568257555,0.00789313904068,0.0032683502884857,0.0011304149715698,1.155406186085261
3876100320,482500.0,6,4.5,2940,7500,1.5,0,0,4,8,2940,0,98034,47.7208,-122.182,2010,7500,4560,5490,54,-930,0,543,446000.0,0.0027377666528847,0.0014136660035002,0.0032576899211062,0.0,0.001934841097565,0.0016266665741274,1.0818385650224216
291310100,400000.0,3,2.5,1600,2388,2.0,0,0,3,8,1600,0,98027,47.5345,-122.069,1410,1287,788,-123,16,-190,-1101,411,571000.0,0.0015472705663687,0.0001764462180031,0.0018410505955223,0.0,0.00144334265876,0.0001098837955382,0.7005253940455342
7856620870,855000.0,3,2.0,3120,9400,1.0,0,0,5,9,1820,1300,98006,47.5612,-122.15,2770,9500,6280,6730,42,-350,100,490,760184.5,0.0022071760102605,0.0014284452998906,0.001614733466948,0.0045383138418572,0.0020309630210758,0.001590164946973,1.1247269577319716
2310040020,365000.0,5,2.5,2260,7040,2.0,0,0,3,8,2260,0,98038,47.352,-122.038,2180,6910,4780,4730,21,-80,-130,586,342750.0,0.001792851125133,0.0004725996903397,0.001874255688283,0.0,0.0017547262908708,0.000589240117309,1.0649161196207149
5631500866,563000.0,4,3.0,3100,15480,2.0,0,0,3,8,2400,700,98028,47.7466,-122.241,2000,42500,12380,40500,24,-1100,27020,282,442500.0,0.0051755427224356,0.0046124293051351,0.0047762049469542,0.0072553897180762,0.0033916240452578,0.0149059992613638,1.272316384180791
3374500290,320900.0,3,2.0,1770,7251,1.0,0,0,4,8,1770,0,98031,47.4087,-122.17,2560,7210,5481,4650,30,790,-41,271,288400.0,0.0033801461292552,0.0022042307490037,0.0038221842163226,0.0,0.004942399805393,0.0031342456987802,1.1126907073509016
7575600100,285000.0,3,2.5,2090,10834,1.0,0,0,4,8,1360,730,98003,47.3537,-122.303,1750,8595,8744,6845,33,-340,-2239,276,269500.0,0.0039206343548868,0.0036944107800137,0.0029623562930467,0.0098671316383493,0.0033719014634052,0.0031869286610005,1.0575139146567718
3275790140,739000.0,3,2.5,2750,16000,2.0,0,0,4,9,2560,190,98033,47.693,-122.187,2370,11279,13250,8909,39,-380,-4721,431,678000.0,0.0026815951883406,0.0035327598339337,0.00288592805697,0.0013723762333328,0.0024912700431609,0.0026355162155865,1.0899705014749264
3222049055,650000.0,3,1.75,2800,19386,1.0,1,4,3,8,1400,1400,98198,47.3554,-122.324,3270,31450,16586,28180,55,470,12064,275,266750.0,0.0058197418113114,0.0066797785949378,0.0034449581806683,0.0187341094607252,0.0069297278969229,0.0120355778569859,2.436738519212746
5605000595,685000.0,6,2.25,2770,5854,1.5,0,0,3,8,2120,650,98112,47.6466,-122.304,2300,5450,3084,3150,99,-470,-404,268,917500.0,0.0041354887640113,0.004373794292699,0.0039465209184224,0.0049008519942697,0.0037612366946251,0.0041488879838307,0.7465940054495913
3878900225,345000.0,3,1.75,1990,5650,1.0,0,1,3,7,1320,670,98178,47.5086,-122.252,2130,5650,3660,3520,57,140,0,258,279500.0,0.0044411712194251,0.002635775071819,0.0038476112746669,0.0063803447290734,0.0050019961017307,0.0026928548789525,1.2343470483005368
5416501030,399000.0,4,2.5,2800,4687,2.0,0,0,3,9,2800,0,98038,47.3594,-122.04,2750,4750,1887,2000,15,-50,63,586,342750.0,0.0022212314824657,0.0003146412995202,0.002322086693448,0.0,0.0022135308715113,0.0004050492846914,1.1641137855579868
4309700130,860000.0,3,3.25,4720,32467,2.0,0,2,3,10,3190,1530,98059,47.508,-122.113,3260,26386,27747,23126,22,-1460,-6081,465,435000.0,0.0042112400852954,0.0048429259823046,0.0030147239495718,0.0244135950215414,0.0029799366169309,0.0045049313341996,1.9770114942528736
4113800330,570000.0,3,2.5,2400,6975,2.0,0,0,3,9,2400,0,98056,47.534,-122.179,2640,11172,4575,8532,27,240,4197,404,380000.0,0.0029460829985232,0.0018025212038515,0.0033230135302034,0.0,0.0034227261235681,0.0035306710455583,1.5
2589300065,329900.0,3,1.75,1670,5209,1.5,0,0,5,7,1670,0,98118,47.5362,-122.271,1990,4960,3539,2970,112,320,-249,498,370000.0,0.0019767828628313,0.0018073990594168,0.002514056889946,0.0,0.002477753138591,0.0017918867989965,0.8916216216216216
1446800995,300000.0,3,2.5,2020,6628,1.0,0,0,4,7,1250,770,98168,47.4934,-122.332,1540,9995,4608,8455,57,-480,3367,264,237000.0,0.005185204199502,0.0022117743950072,0.0038187761586166,0.0123714652956298,0.0039504196679595,0.0038745551239295,1.2658227848101269
1563102685,875000.0,3,2.5,2520,3750,2.0,0,1,4,9,2520,0,98116,47.5671,-122.404,2250,6200,1230,3950,25,-270,2450,329,565500.0,0.0041291709542317,0.0022890852144018,0.0053942743630689,0.0,0.0040356645125186,0.003824792427898,1.5473032714412025
2087700115,650000.0,2,1.5,1900,4450,1.0,0,0,5,7,1500,400,98144,47.5834,-122.293,2130,5000,2550,2870,104,230,550,340,452500.0,0.0029231488775108,0.0031955603971686,0.0029809161746498,0.0027251112186016,0.0035571914553923,0.0037476539686156,1.4364640883977902
7202360670,889000.0,4,3.5,3920,9555,2.0,0,0,3,9,3920,0,98053,47.6797,-122.025,3920,8598,5635,4678,16,0,-957,400,635000.0,0.0037402224669057,0.0006778674538205,0.0038536175835065,0.0,0.0039611364015298,0.0007400386562178,1.4
6450303785,320000.0,3,1.0,1340,5175,1.0,0,0,3,7,940,400,98133,47.7321,-122.34,1020,5500,3835,4480,33,-320,325,484,375000.0,0.0017161929205761,0.0015066625052696,0.0014221867179864,0.0033376723073328,0.0013593094707888,0.0016901323619476,0.8533333333333334
3222059187,460000.0,4,3.0,2230,52983,2.0,0,0,3,8,2230,0,98030,47.3577,-122.195,2060,8755,50753,6695,29,-170,-44228,253,283000.0,0.004473958751304,0.0177436023836299,0.0048702716869048,0.0,0.0042303269262362,0.004035010339858,1.6254416961130742
1773100980,309000.0,3,2.25,1490,1294,2.0,0,0,3,7,1220,270,98106,47.5569,-122.363,1490,1283,-196,-207,10,0,-11,330,315000.0,0.0030277721896076,0.0007085003063415,0.0031025809913509,0.0027303064010516,0.0033121268300056,0.0007625439369139,0.9809523809523808
3797000300,405000.0,2,1.0,880,3000,1.0,0,0,5,7,880,0,98103,47.6868,-122.349,1300,3000,2120,1700,93,420,0,599,550000.0,0.0008897786675564,0.0014394226187991,0.0010455938319469,0.0,0.0014242829283257,0.001442740514462,0.7363636363636363
4365200425,350000.0,2,1.0,740,7680,1.0,0,0,4,6,740,0,98126,47.5245,-122.371,1080,7680,6940,6600,98,340,0,352,396587.5,0.0013606868158641,0.0042778175109786,0.0016834901936696,0.0,0.0021725399003045,0.004348970941739,0.8825290761811706
4027701326,470000.0,4,2.25,2380,17199,2.0,0,0,3,8,1530,850,98028,47.7668,-122.27,2280,11529,14819,9249,41,-100,-5670,282,442500.0,0.0039734811869022,0.0051246234896007,0.0030448306536833,0.0088101160862354,0.0038664514115939,0.004043559187865,1.0621468926553672
8965500820,851000.0,5,3.25,3760,9792,2.0,0,0,3,9,2550,1210,98006,47.5654,-122.115,2960,16500,6032,13540,36,-800,6708,490,760184.5,0.0026599300636473,0.0014880145081414,0.0022624012861085,0.0042241228835747,0.0021702709539294,0.0027618654342162,1.1194650772279624
6070500055,599000.0,4,2.25,2260,29930,2.0,0,0,4,8,1400,860,98006,47.5689,-122.126,2770,29930,27670,27160,43,510,0,490,760184.5,0.001598787751022,0.0045482306197583,0.0012421026668831,0.0030022691569209,0.0020309630210758,0.0050098565118844,0.7879666054753813
1313000650,620000.0,4,2.25,2210,10039,1.0,0,0,4,8,1710,500,98052,47.634,-122.101,2070,10965,7829,8895,53,-140,926,571,615000.0,0.001635077366534,0.0015814554304933,0.0014230930553058,0.0033331111259249,0.0015524351858309,0.0019107920629548,1.008130081300813
4058801065,272000.0,3,2.0,1200,5700,1.0,0,0,5,7,1200,0,98178,47.5031,-122.242,1190,6384,4500,5194,78,-10,684,258,279500.0,0.0026780931976432,0.0026591005149324,0.0034978284315154,0.0,0.0027945424230326,0.0030426877074749,0.9731663685152058
5700002125,480000.0,4,1.75,2320,4322,1.0,0,0,3,7,1140,1180,98144,47.5755,-122.289,1820,4322,2002,2502,110,-500,0,340,452500.0,0.0035693186293816,0.0031036431542838,0.0022654962927339,0.0080390780948747,0.0030394781449831,0.0032394720904713,1.0607734806629834
5634500415,431000.0,3,2.5,1710,12677,2.0,0,0,3,8,1710,0,98028,47.75,-122.234,1610,12160,10967,10550,24,-100,-517,282,442500.0,0.0028548961468919,0.0037772458850903,0.0034030460247049,0.0,0.0027302573564325,0.0042648694357219,0.9740112994350284
5104220120,320000.0,4,1.75,1710,10480,1.5,0,0,4,6,1710,0,98059,47.4743,-122.143,1750,10480,8770,8730,51,40,0,465,435000.0,0.0015256823190371,0.0015632446574845,0.0016160432456952,0.0,0.0015996592268801,0.001789270081953,0.735632183908046
6073300790,383000.0,3,1.5,1340,7725,1.0,0,0,4,8,1340,0,98056,47.5389,-122.173,1990,7725,6385,5735,53,650,0,404,380000.0,0.0016448963408421,0.0019963406881366,0.0018553492210302,0.0,0.0025800094643563,0.0024413206074953,1.0078947368421052
7399200510,383000.0,4,2.5,2370,10580,2.0,0,0,3,8,2370,0,98055,47.464,-122.192,1590,8584,8210,6994,54,-780,-1996,260,297225.0,0.0050969714956708,0.0040345737804566,0.0057436444272108,0.0,0.003422777616326,0.0043449585270064,1.2885860879804862
424069130,584999.0,4,2.75,2050,17859,1.0,0,0,4,7,1300,750,98075,47.5945,-122.056,2960,20908,15809,17948,53,910,3049,358,739999.5,0.0018962922399096,0.0026230612898047,0.0012805648670133,0.0113843351548269,0.0027720105598618,0.0038789949492175,0.7905397233376509
7334401040,271000.0,4,1.5,1800,9576,1.0,0,0,4,7,1800,0,98045,47.4664,-121.747,1370,9576,7776,8206,43,-430,0,218,404750.0,0.0039883451691169,0.0008682713728861,0.004245633483896,0.0,0.0032792771228532,0.0013537184635973,0.6695491043854231
3862710090,417000.0,3,2.5,1570,4926,2.0,0,0,3,8,1570,0,98065,47.5342,-121.842,1800,3202,3356,1402,6,230,-1724,305,500000.0,0.0019935242206844,0.0009368517066068,0.0020886547467007,0.0,0.0023344638190531,0.0009273614192742,0.834
203900610,339000.0,3,1.75,1150,13278,1.0,0,0,5,7,1150,0,98053,47.6384,-121.969,1560,12400,12128,10840,54,410,-878,400,635000.0,0.0010972591420769,0.000941991004901,0.0011305255665899,0.0,0.001576370608772,0.0010672806858689,0.5338582677165354
886000090,395000.0,2,1.0,700,7457,1.0,0,0,3,6,700,0,98108,47.5348,-122.295,1500,7130,6757,5630,77,800,-327,185,345000.0,0.0022184895255601,0.0077257718778588,0.0029127829560585,0.0,0.0051601362275964,0.0076202649885696,1.144927536231884
4013200145,429000.0,3,1.0,1540,37950,1.0,0,0,4,7,1090,450,98001,47.3259,-122.289,1820,24375,36410,22555,61,280,-13575,358,260000.0,0.0022542435402748,0.0070829077211906,0.0017632804133517,0.0069241421757193,0.0027745763435352,0.0060789765671975,1.65
8024202520,445000.0,2,2.0,1150,6634,1.0,0,0,3,7,860,290,98115,47.7001,-122.309,1680,6892,5484,5212,80,530,258,576,570000.0,0.0010889048174095,0.0021130450431511,0.0010601773947989,0.0011840504323825,0.0017241892461906,0.0022637981816694,0.7807017543859649
3025059089,950000.0,3,1.5,1700,8050,1.0,0,0,3,7,1130,570,98004,47.6304,-122.218,2920,12239,6350,9319,70,1220,4189,315,1150000.0,0.0018541139516621,0.0019531354253152,0.0014833094866173,0.003675759334494,0.0034684278044376,0.0030358035813503,0.8260869565217391
3339400349,390000.0,3,2.5,2500,21780,1.0,0,0,3,8,1770,730,98092,47.3282,-122.198,2670,23400,19280,20730,34,170,1620,351,309780.0,0.0032439011414639,0.0019095852587733,0.0024421641713819,0.0159006752341537,0.0035712470473678,0.0022066994641303,1.2589579701723803
6163900301,425000.0,4,1.0,1480,8321,1.0,0,0,3,7,1080,400,98155,47.7629,-122.318,1580,8502,6841,6922,67,100,181,442,377225.0,0.0018790310294042,0.0018270849924982,0.0016581456404587,0.0029344875651089,0.0020794316571096,0.0019572161121566,1.1266485519252436
2207000060,500000.0,3,1.5,1960,8815,1.0,0,0,4,7,1020,940,98006,47.5765,-122.159,1760,9534,6855,7774,62,-200,719,490,760184.5,0.001386559288497,0.0013395473743123,0.0009049605144434,0.0032815500087275,0.001290431378012,0.0015958560636253,0.657735063001153
5104470070,485000.0,4,3.0,3110,18843,2.0,0,0,3,9,3110,0,98058,47.4619,-122.154,3080,14735,15733,11655,25,-30,-4108,451,335000.0,0.0033558785064074,0.0021345139107029,0.0038118257297011,0.0,0.0034499019354173,0.0023681658085715,1.4477611940298507
8079010310,464000.0,4,2.5,2180,7203,2.0,0,0,4,8,2180,0,98059,47.5119,-122.151,2350,7334,5023,4984,31,170,131,465,435000.0,0.0019450219038017,0.0010744323728875,0.002060218874629,0.0,0.0021481138189533,0.001252147593611,1.0666666666666669
9407150240,295000.0,3,2.5,1460,7936,2.0,0,0,3,7,1460,0,98038,47.3673,-122.017,1830,7936,6476,6106,25,370,0,586,342750.0,0.0011582135587142,0.0005327487418375,0.0012108023472979,0.0,0.0014730041799512,0.0006767307628024,0.8606856309263311
2332700060,950000.0,4,2.25,2620,10920,1.0,0,0,3,9,2620,0,98005,47.6117,-122.164,2370,11907,8300,9537,55,-250,987,168,765475.0,0.0058699251472522,0.0032616136744049,0.0072193611140962,0.0,0.00549372857272,0.0038586603218758,1.241059472876319
7853350170,675000.0,5,2.5,3200,6455,2.0,0,0,3,9,3200,0,98065,47.5446,-121.862,3290,7924,3255,4634,11,90,1469,305,500000.0,0.0040632340803758,0.0012276446947111,0.0042571306939123,0.0,0.0042668810914915,0.0022949443742439,1.35
2473370750,430000.0,3,1.75,3440,10428,1.5,0,0,5,8,3440,0,98058,47.449,-122.128,2160,8400,6988,6240,46,-1280,-2028,451,335000.0,0.003711968508695,0.0011812721467287,0.004216295983978,0.0,0.002419411746916,0.0013500232637937,1.2835820895522387
9476700035,400000.0,4,2.0,2680,13680,2.0,0,2,4,7,2350,330,98056,47.4887,-122.192,1430,11000,11000,9570,77,-1250,-2680,404,380000.0,0.0032897926816843,0.0035352673933605,0.0032537840816575,0.0035712353227639,0.0018539766502661,0.0034763141336503,1.0526315789473684
3568200060,245000.0,3,3.0,1990,9600,1.0,0,0,3,7,1440,550,98003,47.3499,-122.296,1670,9600,7610,7930,32,-320,0,276,269500.0,0.0037330441943659,0.0032736148687587,0.0031366125455789,0.0074341402754686,0.0032177573965067,0.0035595712793025,0.9090909090909092
2525059127,445000.0,4,2.0,1700,21780,1.0,0,0,4,6,1080,620,98052,47.6289,-122.108,2070,12054,20080,9984,80,370,-9726,571,615000.0,0.0012577518204107,0.0034310289148465,0.0008987956138774,0.0041330577961469,0.0015524351858309,0.002100564297935,0.7235772357723578
7696610270,238000.0,3,1.5,1360,7488,1.0,0,0,4,7,1050,310,98001,47.3314,-122.275,1580,7508,6128,5928,45,220,20,358,260000.0,0.0019907605290738,0.0013975444800072,0.0016985728752471,0.0047699646099399,0.0024086981443877,0.001872449479652,0.9153846153846154
3023049186,575000.0,3,2.0,2500,30056,1.0,0,0,5,8,1840,660,98166,47.4468,-122.337,2500,30000,27556,27500,66,0,-56,250,392500.0,0.0048159535202693,0.0087999627576769,0.0042944498903048,0.0072809107757479,0.0052906693754893,0.0094293454431273,1.464968152866242
2600040160,753000.0,3,2.25,2290,9047,2.0,0,0,4,8,2290,0,98006,47.5545,-122.163,2120,9275,6757,7155,36,-170,228,490,760184.5,0.0016200105972745,0.0013748026200118,0.0020317250765445,0.0,0.0015543832507872,0.0015525031455973,0.9905490048797364
3923400123,294950.0,4,2.0,2610,14321,1.5,0,0,4,6,1690,920,98188,47.4672,-122.296,1630,8599,11711,6969,80,-980,-5722,135,265000.0,0.0107043108433438,0.0104651477185451,0.0083836434619982,0.0217782406969037,0.0073677644485024,0.0065258586865865,1.1130188679245283
2579500101,1387000.0,4,3.5,4010,10880,2.0,0,3,4,11,3150,860,98040,47.5359,-122.213,3530,17310,6870,13780,30,-480,6430,282,993750.0,0.0045769620157808,0.0028152548517217,0.004514439758026,0.0048215467073321,0.0043183280608138,0.0047950643247768,1.3957232704402516
7504200120,430000.0,3,2.0,1910,5040,1.5,0,0,3,8,1910,0,98074,47.6312,-122.061,1980,4275,3130,2295,49,70,-765,435,645000.0,0.0016557884543864,0.0007941471356105,0.0017949626394032,0.0,0.0017574988838106,0.0007437423864266,0.6666666666666666
9542840450,274000.0,3,1.5,1450,4694,2.0,0,0,3,7,1450,0,98038,47.3654,-122.021,1870,4198,3244,2328,9,420,-496,586,342750.0,0.001150280589134,0.000315111213985,0.0012025091805356,0.0,0.0015052009926277,0.0003579782941336,0.799416484318016
6852700478,425000.0,2,1.0,970,2970,1.0,0,0,3,7,970,0,98102,47.6233,-122.319,1670,3000,2000,1330,110,700,30,104,710000.0,0.0043359900585135,0.007921351910726,0.0053222425845248,0.0,0.0082158758271222,0.0087319975317553,0.5985915492957746
8951900065,315000.0,3,1.0,1070,9497,1.0,0,0,3,7,1070,0,98028,47.7425,-122.23,1710,9561,8427,7851,65,640,64,282,442500.0,0.0017863970041955,0.0028297313379113,0.0021293913721837,0.0,0.0028998385586954,0.0033533237397152,0.711864406779661
868000575,998800.0,3,2.0,2250,8000,1.0,0,2,4,9,2250,0,98177,47.7077,-122.378,2880,10960,5750,8080,65,630,2960,254,557000.0,0.0038091690932484,0.0026420463177139,0.0048170381851969,0.0,0.0051863857374392,0.0036866260240814,1.793177737881508
7967650010,339000.0,4,2.5,2900,6918,2.0,0,0,3,8,2900,0,98001,47.3504,-122.284,2720,10376,4018,7656,19,-180,3458,358,260000.0,0.0042450040693487,0.0012911608857759,0.0046912965125872,0.0,0.0041466195903383,0.0025877112148201,1.303846153846154
522059013,173000.0,2,1.0,820,10450,1.0,0,0,4,7,820,0,98055,47.4261,-122.199,1240,11200,9630,9960,55,420,750,260,297225.0,0.0017635091250844,0.0039849996224737,0.0019872525022417,0.0,0.0026693360026693,0.0056690977985172,0.582050635040794
2597501190,270000.0,3,2.25,2080,26574,1.0,0,2,3,7,1380,700,98002,47.2846,-122.192,1770,8140,24494,6370,27,-310,-18434,197,235000.0,0.0064878150723173,0.0179636346921089,0.0046051424090234,0.0334352311807413,0.0060771071596562,0.0054456356307805,1.148936170212766
722059002,380000.0,2,2.5,2110,114127,1.0,0,0,4,8,1590,520,98031,47.4137,-122.212,1960,11250,112017,9290,45,-150,-102877,271,288400.0,0.0040294397360048,0.0346934550671012,0.0034334875163576,0.0085865257595772,0.003784024851004,0.0048904665896363,1.317614424410541
2616700560,250000.0,3,2.0,1660,13085,1.0,0,0,3,7,1010,650,98001,47.3298,-122.277,1660,7778,11425,6118,35,0,-5307,358,260000.0,0.0024298988810754,0.0024421567202049,0.0016338653371424,0.0100015386982612,0.0025306575441035,0.0019397858354733,0.9615384615384616
1972200382,387000.0,2,1.5,1010,948,3.0,0,0,3,8,1010,0,98103,47.6529,-122.355,1330,1318,-62,-12,21,320,370,599,550000.0,0.0010212232434454,0.0004548575475405,0.0012000565571209,0.0,0.0014571509959024,0.0006338439993536,0.7036363636363636
9578501030,432500.0,4,2.5,3172,5033,2.0,0,0,3,8,3172,0,98023,47.2961,-122.348,2704,5232,1861,2528,6,-468,199,492,269000.0,0.0032257900490682,0.0009745028012356,0.0037632833104554,0.0,0.0027882267537781,0.0010905921006279,1.607806691449814
3885802970,827500.0,3,2.5,1810,7200,1.0,0,0,5,7,1310,500,98033,47.6885,-122.211,2050,7200,5390,5150,60,240,0,431,678000.0,0.0017649771966896,0.0015897419252702,0.0014767834979026,0.0036115164035075,0.0021548960288945,0.0016823935412911,1.2205014749262535
5103300020,765000.0,4,2.5,4040,25752,2.0,0,0,3,10,4040,0,98038,47.4579,-122.068,3230,22247,21712,19017,20,-810,-3505,586,342750.0,0.0032049197104148,0.0017287481854588,0.003350439371975,0.0,0.0025998926236297,0.0018970803024277,2.231947483588621
3574800090,446950.0,5,2.5,2250,7945,1.0,0,0,4,7,1360,890,98034,47.7316,-122.221,1820,7866,5695,6046,43,-430,-79,543,446000.0,0.0020952295812893,0.0014975435197079,0.0015069586029607,0.0051928956519709,0.001751945670432,0.0017060479029448,1.0021300448430492
8691300500,710000.0,4,2.5,2880,12349,2.0,0,0,3,10,2880,0,98075,47.5879,-121.973,3490,11539,9469,8049,24,610,-810,358,739999.5,0.0026640593419218,0.0018137736641356,0.0028369437053833,0.0,0.0032683502884857,0.0021407940845141,0.959460107743316
1798000100,750500.0,5,3.0,2170,2440,1.5,0,0,4,8,1450,720,98115,47.6724,-122.317,2070,4000,270,1930,109,-100,1560,576,570000.0,0.0020547160467642,0.0007771826809298,0.0017875083982075,0.0029397114183291,0.0021244474640562,0.001313870099634,1.3166666666666669
2595300210,473600.0,4,1.5,1780,8400,1.0,0,0,3,7,1080,700,98136,47.5173,-122.385,1660,8400,6620,6740,51,-120,0,263,489950.0,0.0039193581060252,0.0053389264944227,0.0030370349540226,0.0071032817161528,0.0037746145800172,0.0055513736675877,0.966629247882437
1604600095,362000.0,5,3.0,1810,3000,2.0,0,0,3,7,1810,0,98118,47.5622,-122.291,1670,3000,1190,1330,22,-140,0,498,370000.0,0.0021425011866615,0.0010409286193608,0.002724816150181,0.0,0.0020793204730889,0.001083802499393,0.9783783783783784
5422420120,252000.0,3,2.0,1420,6788,2.0,0,0,3,7,1420,0,98023,47.2887,-122.351,1790,6607,5368,4817,30,370,-181,492,269000.0,0.0014440800345765,0.0013143105533057,0.00168469807719,0.0,0.0018457566158516,0.0013772060414466,0.9368029739776952
7853280490,633000.0,4,3.5,4220,5817,2.0,0,0,3,9,2910,1310,98065,47.5392,-121.862,4290,6637,1597,2347,14,70,820,305,500000.0,0.0053583899434956,0.0011063066133438,0.0038713282247765,0.0365207694452188,0.0055638054354099,0.0019222041660596,1.266
31200020,1038000.0,5,2.75,3050,8904,1.0,0,0,4,8,1650,1400,98040,47.5709,-122.214,2920,8904,5854,5984,64,-130,0,282,993750.0,0.0034812304608806,0.002303954889681,0.0023647065399183,0.0078490295235639,0.0035721013987468,0.0024665079577014,1.0445283018867924
818100030,310000.0,4,2.5,1930,7014,2.0,0,0,3,8,1930,0,98042,47.3921,-122.163,1990,7920,5084,5930,26,60,906,546,292000.0,0.0017824521739451,0.0006761331737502,0.0019133386470613,0.0,0.0018622723278497,0.0009847243393519,1.0616438356164384
2231000020,432500.0,3,2.5,1930,7120,1.0,0,0,4,7,1420,510,98133,47.7715,-122.34,1600,8352,5190,6752,59,-330,1232,484,375000.0,0.0024718301020238,0.0020729346932406,0.0021484097229156,0.0042555321918494,0.002132250150257,0.0025665428158158,1.153333333333333
1541700010,315000.0,4,2.5,2040,6300,2.0,0,0,3,8,2040,0,98031,47.3918,-122.185,2260,5877,4260,3617,17,220,-423,271,288400.0,0.0038957616404975,0.0019151363561886,0.0044052292662701,0.0,0.0043632123281985,0.002554779746426,1.0922330097087378
3229200040,215000.0,3,1.75,1430,13399,1.0,0,0,4,7,900,530,98168,47.4787,-122.275,1720,6415,11969,4695,74,290,-6984,264,237000.0,0.0036707138640039,0.0044712681229183,0.002749518834204,0.0085154241645244,0.004412157031747,0.0024867704972494,0.9071729957805909
1338801060,560000.0,4,1.5,1810,3400,2.0,0,0,3,8,1810,0,98112,47.6264,-122.302,1770,3600,1590,1830,94,-40,200,268,917500.0,0.0027022507808161,0.0025402973343315,0.0033694353124267,0.0,0.0028945169345593,0.002740549860879,0.6103542234332425
2321059093,506000.0,3,2.5,2100,213008,1.0,0,0,3,8,2100,0,98092,47.2984,-122.144,1330,214315,210908,212985,30,-770,1307,351,309780.0,0.0027248769588297,0.018675708760367,0.0028974829151989,0.0,0.0017789357951307,0.0202106322929531,1.6334172638646782
7430500415,540000.0,2,1.0,1120,7500,1.0,0,2,4,7,1120,0,98008,47.619,-122.096,3040,16940,6380,13900,49,1920,9440,283,545000.0,0.0018550263761562,0.0026011581743476,0.0023102119619475,0.0,0.0053148711493408,0.0063042316503689,0.9908256880733946
646910020,250000.0,3,2.5,1650,2802,2.0,0,0,3,7,1650,0,98055,47.4328,-122.196,1490,2084,1152,594,16,-160,-718,260,297225.0,0.0035485244590113,0.0010685137743704,0.0039987397910961,0.0,0.0032075085838526,0.0010548571260812,0.8411136344520145
1508210230,567000.0,3,2.25,1800,6875,1.0,0,0,4,8,1230,570,98052,47.6773,-122.11,1800,8749,5075,6949,46,0,1874,571,615000.0,0.0013317372216114,0.0010830268039288,0.001023628338027,0.0037997466835544,0.001349943639853,0.001524625604997,0.9219512195121952
290000075,550000.0,3,1.0,1260,6000,1.0,0,3,3,7,1260,0,98146,47.5058,-122.384,2020,6600,4740,4580,69,760,600,281,312000.0,0.0027562792854674,0.0023696579517229,0.0032533088216308,0.0,0.0046722703070282,0.0028415720265316,1.7628205128205128
7299601870,299000.0,3,2.5,1572,4000,2.0,0,0,3,8,1572,0,98092,47.2615,-122.198,1608,5175,2428,3567,7,36,1175,351,309780.0,0.0020397650377525,0.000350704363411,0.0021689729250917,0.0,0.0021507735026844,0.000488020073798,0.9652011104654916
3832050760,270000.0,3,2.5,1870,5000,2.0,0,0,3,7,1870,0,98042,47.3339,-122.055,2170,5399,3130,3229,11,300,399,546,292000.0,0.0017270391529935,0.0004819882903836,0.0018538566165827,0.0,0.0020307190710723,0.0006712786247678,0.9246575342465754
2591780180,365000.0,5,2.75,3260,9253,2.0,0,0,3,8,3260,0,98042,47.3674,-122.07,2770,8067,5993,5297,16,-490,-1186,546,292000.0,0.0030107741383737,0.000891967530184,0.0032318569893368,0.0,0.0025922082151476,0.0010030014198929,1.25
4406000390,255000.0,3,1.5,1060,9039,1.0,0,0,3,7,1060,0,98058,47.4293,-122.151,1410,9515,7979,8105,47,350,476,451,335000.0,0.0011438042497723,0.0010239277842617,0.0012992074834351,0.0,0.0015793382236813,0.0015292227803568,0.7611940298507462
7511210310,720500.0,4,2.5,3350,35298,2.0,0,0,4,9,3350,0,98053,47.6506,-122.036,2620,35604,31948,32984,35,-730,306,400,635000.0,0.0031963635877893,0.0025041722014609,0.0032932701287619,0.0,0.0026474942275531,0.0030644727048128,1.1346456692913385
5560000540,223000.0,4,2.0,1200,8470,1.0,0,0,4,7,1200,0,98023,47.3262,-122.338,1110,8400,7270,7290,59,-90,-70,492,269000.0,0.0012203493249942,0.0016399838518709,0.0014236885159352,0.0,0.0011445753316175,0.0017509506202742,0.828996282527881
4051100230,240000.0,3,1.0,1340,7000,1.0,0,0,4,7,1340,0,98042,47.3742,-122.149,1850,7904,5660,6054,42,510,904,546,292000.0,0.0012375574679204,0.0006747836065371,0.0013284320140218,0.0,0.0017312581942321,0.0009827349972522,0.821917808219178
2249500367,736000.0,3,2.5,1980,2975,3.0,0,2,3,8,1980,0,98109,47.6294,-122.344,1980,3144,995,1164,27,0,169,109,736000.0,0.0088404302342714,0.007537408347648,0.0110942394002386,0.0,0.0094200485275227,0.0079995114802149,1.0
339600460,419500.0,3,2.5,1360,3188,2.0,0,0,3,7,1360,0,98052,47.6831,-122.096,1090,3188,1828,2098,34,-270,0,571,615000.0,0.0010062014563286,0.00050220937468,0.0011318166989567,0.0,0.0008174658707998,0.0005555499404195,0.6821138211382114
3629960600,350000.0,3,1.75,1260,1111,2.0,0,0,3,8,1260,0,98029,47.5476,-122.005,1410,1630,-149,220,17,150,519,320,574500.0,0.0017259328255985,0.0003995118116691,0.0018150388936905,0.0,0.0019920037297091,0.0007223986115764,0.6092254134029591
3362400092,565000.0,3,2.25,1540,1005,3.0,0,0,3,8,1540,0,98103,47.6828,-122.346,1510,1501,-535,-9,12,-30,496,599,550000.0,0.0015571126682237,0.0004822065772977,0.0018297892059071,0.0,0.0016543594013629,0.0007218511707358,1.0272727272727271
9218400088,495000.0,5,1.0,1810,11205,1.5,0,2,3,7,1810,0,98178,47.5099,-122.262,1860,7965,9395,6105,105,50,-3240,258,279500.0,0.0040394572397786,0.0052272318017225,0.0052758912175357,0.0,0.0043679402578493,0.0037962104620986,1.7710196779964222
1102001055,518000.0,3,1.0,1270,6612,1.5,0,3,3,7,1270,0,98118,47.5433,-122.264,2100,7680,5342,5580,93,830,1068,498,370000.0,0.0015033019376023,0.0022942066770713,0.0019118875749888,0.0,0.0026147143673574,0.0027745343984462,1.4
7885801460,325000.0,4,2.5,2260,5702,2.0,0,0,3,8,2260,0,98042,47.3488,-122.151,2450,6381,3442,3931,18,190,679,546,292000.0,0.0020872237891793,0.0005496594463535,0.0022404898146936,0.0,0.0022927473383075,0.0007933744961369,1.1130136986301369
3905100280,478000.0,3,2.25,1640,3896,2.0,0,0,3,8,1640,0,98029,47.5689,-122.006,1780,3999,2256,2219,26,140,103,320,574500.0,0.0022464522491918,0.0014009883152683,0.0023624315759147,0.0,0.0025147281126824,0.0017723141396897,0.8320278503046127
8097000330,359950.0,3,2.75,2540,8604,2.0,0,0,3,8,2540,0,98092,47.3209,-122.185,2260,7438,6064,5178,29,-280,-1166,351,309780.0,0.0032958035597273,0.0007543650856972,0.0035045745736215,0.0,0.0030228533060117,0.0007014286587265,1.1619536445219187
2346800270,555000.0,3,3.0,2920,23085,1.5,0,2,3,7,1540,1380,98136,47.5159,-122.395,2270,18180,20165,15910,112,-650,-4905,263,489950.0,0.0064295088031425,0.014672514062351,0.0043305868788841,0.0140036125261299,0.0051616717449633,0.0120147587234219,1.132768649862231
6699930550,338000.0,3,2.5,2470,4948,2.0,0,0,3,8,2470,0,98038,47.3438,-122.039,2500,4993,2478,2493,17,30,45,586,342750.0,0.001959443486318,0.0003321623959945,0.0020484121902916,0.0,0.002012300792283,0.0004257707533609,0.9861415025528812
3339900096,250750.0,5,1.75,2140,12058,1.0,0,0,4,8,2140,0,98002,47.3167,-122.214,1640,10125,9918,8485,69,-500,-1933,197,235000.0,0.0066749635840187,0.0081510313508485,0.0071413077937029,0.0,0.0056307659558396,0.0067735946881637,1.0670212765957447
1180000885,340500.0,3,2.5,3070,5871,3.0,0,0,4,8,2510,560,98178,47.5007,-122.223,2220,4000,2801,1780,92,-850,-1871,258,279500.0,0.006851455097304,0.0027388735303804,0.0073162911359197,0.0053328254451956,0.0052133480496911,0.0019064459320018,1.2182468694096602
8081010040,1150000.0,3,2.5,3160,24437,1.0,0,3,3,11,2160,1000,98006,47.5531,-122.131,3990,11977,21277,7987,29,830,-12460,490,760184.5,0.0022354731385972,0.0037135018929179,0.0019163869717625,0.0034910106475824,0.0029254665899251,0.0020047795336732,1.512790644902652
8097000190,350000.0,3,2.5,2680,7836,2.0,0,0,3,8,2680,0,98092,47.3203,-122.185,2340,8040,5156,5700,30,-340,204,351,309780.0,0.0034774620236493,0.0006870298479223,0.0036977401013015,0.0,0.0031298569628617,0.0007581993030601,1.129834075795726
3629960170,445000.0,3,3.25,1710,1960,2.0,0,0,3,8,1360,350,98029,47.5479,-122.003,1420,955,250,-465,16,-290,-1005,320,574500.0,0.0023423374061695,0.0007048093167161,0.001959089599539,0.009765625,0.0020061314157354,0.0004232458123039,0.7745865970409052
8656300385,305000.0,3,1.0,1710,19115,1.0,0,0,3,6,1710,0,98014,47.656,-121.913,1650,15144,17405,13494,34,-60,-3971,123,415000.0,0.0065620826745667,0.0015936904033574,0.007010552726736,0.0,0.0069682585266145,0.0015697018520077,0.7349397590361446
3300701285,452000.0,3,1.5,1250,4000,1.0,0,0,3,7,1250,0,98117,47.6916,-122.379,1030,4000,2750,2970,65,-220,0,548,545000.0,0.0013471308268796,0.0015744665608887,0.0017089389813083,0.0,0.0012204080665418,0.0015724722999176,0.8293577981651377
7525530670,745000.0,4,2.5,3130,10860,2.0,0,0,3,10,3130,0,98075,47.56,-122.04,3130,10860,7730,7730,30,0,0,358,739999.5,0.0028953144931303,0.0015950750662007,0.003083206179809,0.0,0.0029312138690431,0.0020148213673475,1.006757436998268
6154900070,700000.0,3,2.75,2500,7378,1.0,0,0,5,7,1390,1110,98177,47.7032,-122.37,2040,7140,4878,5100,72,-460,-238,254,557000.0,0.0042324101036093,0.0024366272165117,0.0029758591455216,0.0089814545101466,0.0036736898973527,0.0024016888514545,1.2567324955116697
6437400101,284000.0,2,1.0,860,7204,1.0,0,0,3,7,860,0,98106,47.5361,-122.351,1200,7500,6344,6300,102,340,296,330,315000.0,0.0017475732101091,0.0039443865586431,0.002187065288985,0.0,0.0026674846953065,0.0044575834192161,0.9015873015873016
7199340620,532000.0,4,1.75,2020,7029,1.0,0,0,4,7,1430,590,98052,47.6983,-122.127,1780,7200,5009,5420,41,-240,171,571,615000.0,0.0014945051042528,0.0011072866043368,0.0011900719702265,0.0039330711285914,0.0013349442660768,0.0012546924626789,0.865040650406504
328000160,1400000.0,5,3.75,3700,7920,3.0,0,4,3,9,2900,800,98115,47.6865,-122.266,2860,6360,4220,3500,37,-840,-1560,576,570000.0,0.0035034328907961,0.0025226585381002,0.0035750167964151,0.0032663460203656,0.0029352269310149,0.0020890534584181,2.456140350877193
1891100130,639000.0,3,2.25,1400,2421,2.0,0,0,3,9,1400,0,98034,47.695,-122.169,1500,2743,1021,1243,15,100,322,543,446000.0,0.0013036984061355,0.0004563313859298,0.0015512809148125,0.0,0.0014439112668396,0.0005949261883775,1.4327354260089686
4083303815,695000.0,5,2.0,3160,3990,1.5,0,0,3,7,1870,1290,98103,47.654,-122.337,1780,4240,830,2460,97,-1380,250,599,550000.0,0.0031951143062254,0.0019144320830028,0.0022218868928872,0.0087527055359166,0.0019501720095536,0.0020390732604396,1.2636363636363637
6742700210,1050000.0,3,3.0,3490,4500,2.5,0,0,3,9,3170,320,98102,47.6394,-122.321,2840,4050,1010,1210,96,-650,-450,104,710000.0,0.0156006240249609,0.0120020483495849,0.0173933082401483,0.0077192136051139,0.0139719085922318,0.0117881966678697,1.4788732394366195
6738700335,1695000.0,4,2.75,3770,10900,2.0,0,2,5,9,3070,700,98144,47.5849,-122.29,3000,5000,7130,2000,96,-770,-5900,340,452500.0,0.0058001427727451,0.0078273277144131,0.0061009417707834,0.0047689446325528,0.0050101288104117,0.0037476539686156,3.74585635359116
4395600060,935000.0,2,2.5,1780,2067,2.0,0,0,5,9,1780,0,98004,47.6132,-122.21,2320,2067,287,-253,46,540,0,315,1150000.0,0.0019413663729168,0.0005015069470964,0.002336540607238,0.0,0.0027557371596902,0.0005127057768323,0.8130434782608695
3324069541,695000.0,4,3.5,3310,21050,2.0,0,0,5,9,2400,910,98027,47.5197,-122.041,2260,23400,17740,21140,28,-1050,2350,411,571000.0,0.0032009159841752,0.0015553571561834,0.0027615758932835,0.0055148172838009,0.0023134428431188,0.0019978871916049,1.2171628721541157
1310980110,299000.0,3,2.25,1920,7840,2.0,0,0,4,8,1920,0,98032,47.3631,-122.276,2170,7210,5920,5040,38,250,-630,123,250000.0,0.0089424608534461,0.0061312510019981,0.0108634151861491,0.0,0.0105622319894475,0.0063084527141658,1.196
5561301220,589900.0,4,4.5,3870,35889,2.0,0,0,3,10,2530,1340,98027,47.4677,-122.01,3020,35366,32019,32346,19,-850,-523,411,571000.0,0.0037424606824043,0.0026517915904166,0.0029111612541696,0.0081207199563662,0.0030914147726632,0.0030195418127479,1.0330998248686516
7851200040,265000.0,3,1.0,960,9748,1.0,0,0,3,5,960,0,98065,47.5259,-121.815,1600,9958,8788,8358,98,640,210,305,500000.0,0.0012189702241127,0.0018539241648402,0.0012771392081736,0.0,0.0020750789502694,0.0028840302976679,0.53
3323500010,1150000.0,3,2.5,2100,15120,1.0,0,0,4,8,2100,0,98004,47.6201,-122.222,3070,16078,13020,13008,67,970,958,315,1150000.0,0.0022903760579356,0.0036684978423312,0.0027565928512358,0.0,0.0036466004656245,0.0039880423221627,1.0
3601200017,175000.0,4,2.5,1780,6000,2.0,0,0,3,7,1780,0,98198,47.3828,-122.302,1630,6000,4220,4370,29,-150,0,275,266750.0,0.0036996930086194,0.0020674028458489,0.0043800182582783,0.0,0.0034542680342459,0.002296135680188,0.6560449859418932
1972202010,435000.0,3,3.0,1440,1350,3.5,0,2,3,8,1440,0,98103,47.6525,-122.345,1440,1350,-90,-90,15,0,0,599,550000.0,0.0014560014560014,0.0006477401784596,0.001710971725004,0.0,0.0015776672436838,0.0006492332315079,0.7909090909090909
3728800320,264000.0,3,1.5,1470,14821,1.0,0,0,4,7,1470,0,98042,47.3658,-122.148,1760,15370,13351,13610,62,290,549,546,292000.0,0.0013576190133157,0.0014287096903552,0.0014573097467255,0.0,0.0016470348226209,0.0019110117545251,0.9041095890410958
1794500870,710000.0,3,1.0,1400,2250,1.5,0,0,3,7,1400,0,98119,47.6373,-122.358,1630,3600,850,1970,111,230,1350,184,744975.0,0.0037936986665149,0.0033824413710162,0.0047854576777541,0.0,0.0047488637687915,0.0052488922650282,0.9530521158428136
1402970070,334888.0,3,2.5,1769,7324,2.0,0,0,3,9,1769,0,98092,47.3307,-122.188,2502,6017,5555,3515,8,733,-1307,351,309780.0,0.0022953844476998,0.0006421396894056,0.0024407844176128,0.0,0.0033465393679829,0.0005674235331483,1.081051068500226
200500610,571000.0,3,2.5,2600,7465,2.0,0,0,3,9,2600,0,98011,47.7387,-122.217,2660,7683,4865,5023,32,60,218,194,470000.0,0.0059400873649772,0.0033947542066075,0.0068397833367093,0.0,0.006093440388514,0.0041612797871643,1.2148936170212763
5269200050,175000.0,2,1.0,700,8174,1.0,0,0,3,5,700,0,98146,47.5136,-122.349,1250,8046,7474,6796,79,550,-128,281,312000.0,0.0015312662697041,0.0032282640162305,0.0018073937897949,0.0,0.0028912563781115,0.0034641346250717,0.5608974358974359
7100000135,330000.0,2,1.0,860,8308,1.0,0,0,4,7,860,0,98146,47.5075,-122.377,1310,8308,7448,6998,72,450,0,281,312000.0,0.0018812699884936,0.0032811863771523,0.0022205123703194,0.0,0.0030300366842609,0.0035769364237007,1.0576923076923077
7504400290,599000.0,5,2.5,3470,12003,2.0,0,0,3,8,3470,0,98074,47.624,-122.048,2220,12283,8533,10063,42,-1250,280,435,645000.0,0.0030081601762937,0.0018912992199867,0.0032610054234185,0.0,0.0019705290515453,0.0021369328029188,0.9286821705426356
4438400050,239000.0,2,1.0,710,14000,1.0,0,0,4,6,710,0,98166,47.4379,-122.337,1500,10540,13290,9040,67,790,-3460,250,392500.0,0.0013677307997565,0.0040989978243105,0.0016570975120197,0.0,0.0031744016252936,0.0033128433656854,0.6089171974522293
7120000210,275000.0,2,2.5,1340,5995,2.0,0,0,3,7,1340,0,98028,47.7366,-122.233,1540,6616,4655,5076,31,200,621,282,442500.0,0.0022371700800205,0.0017862734938168,0.0026667144287161,0.0,0.0026115505148485,0.0023204256732513,0.6214689265536724
1072010510,435000.0,4,2.25,2210,14073,1.0,0,0,3,8,1630,580,98059,47.4774,-122.142,2340,11340,11863,9000,42,130,-2733,465,435000.0,0.001971788260276,0.0020991929451126,0.0015404388833235,0.0092548268709111,0.0021389729090854,0.0019360994970751,1.0
2807100156,295950.0,2,1.0,1190,6200,1.0,0,0,3,7,1190,0,98133,47.7634,-122.34,1470,7800,5010,6330,72,280,1600,484,375000.0,0.0015240817727504,0.0018050835811926,0.001800427866387,0.0,0.0019590048255486,0.0023969149860348,0.7892
2726079098,560000.0,3,2.5,2840,216493,2.0,0,0,3,9,2840,0,98014,47.702,-121.892,2820,175111,213653,172291,29,-20,-41382,123,415000.0,0.0108984297051284,0.0180498465338255,0.0116432571601931,0.0,0.011909387300032,0.0181505587035738,1.3493975903614457
1062100075,455000.0,2,1.0,980,5000,1.0,0,0,4,7,980,0,98155,47.7518,-122.279,1600,5965,4020,4365,70,620,965,442,377225.0,0.0012442232492001,0.0010978758517595,0.0015046136367125,0.0,0.0021057535768198,0.0013731820876281,1.2061766850023197
624069098,621500.0,3,1.75,2570,39634,2.0,0,0,3,8,2570,0,98075,47.596,-122.08,2990,39634,37064,36644,36,420,0,358,739999.5,0.0023773029544233,0.0058212896108472,0.0025315782370956,0.0,0.002800105261482,0.0073531703566716,0.8398654323415083
1217000481,345000.0,3,1.75,1930,9000,1.0,0,1,4,7,1150,780,98166,47.4539,-122.348,1590,9000,7070,7410,69,-340,0,250,392500.0,0.0037179161176479,0.0026350700299139,0.0026840311814405,0.0086047127349748,0.0033648657228112,0.0028288036329382,0.8789808917197452
6806100250,316500.0,3,2.5,1770,3873,2.0,0,0,3,7,1770,0,98058,47.4648,-122.144,2280,4330,2103,2050,15,510,457,451,335000.0,0.0019099372849971,0.0004387290970733,0.0021694313638491,0.0,0.0025538235106336,0.0006959048490746,0.9447761194029852
3905040070,540000.0,3,2.5,1670,5146,2.0,0,0,3,8,1670,0,98029,47.5707,-121.999,1940,5146,3476,3206,29,270,0,320,574500.0,0.0022875458878965,0.00185048405297,0.0024056467876692,0.0,0.0027407710891033,0.0022806523037867,0.9399477806788512
4263200030,299500.0,3,1.0,1280,6726,1.0,0,0,3,6,1280,0,98144,47.5724,-122.301,1630,5000,5446,3370,62,350,-1726,340,452500.0,0.0019692792437967,0.0048299638722149,0.0025437151357012,0.0,0.0027221699869903,0.0037476539686156,0.661878453038674
5045700250,565997.0,5,2.75,2730,5820,2.0,0,0,3,8,2730,0,98059,47.4856,-122.154,2730,5700,3090,2970,6,0,-120,465,435000.0,0.0024357384391645,0.0008681377773435,0.0025799988659345,0.0,0.0024954683939329,0.000973171704879,1.3011425287356322
7437100770,275000.0,3,2.5,2030,6326,2.0,0,0,3,7,2030,0,98038,47.3491,-122.029,1810,6825,4296,5015,27,-220,499,586,342750.0,0.0016103928247876,0.0004246684149274,0.0016835128527498,0.0,0.0014569057736129,0.0005819918669514,0.8023340627279358
8818900300,618000.0,4,1.0,1260,4080,1.0,0,0,4,7,1260,0,98105,47.6644,-122.324,1340,4080,2820,2740,109,80,0,229,675000.0,0.0025584691420194,0.0034790112445395,0.003249080716448,0.0,0.0028844808472624,0.0036073154234838,0.9155555555555556
2422049104,235000.0,2,1.0,830,9000,1.0,0,0,3,6,830,0,98032,47.3813,-122.243,1160,7680,8170,6520,81,330,-1320,123,250000.0,0.0038657513064376,0.0070384258951509,0.0046961638565123,0.0,0.0056461700957415,0.0067196833349228,0.94
8562500380,679000.0,4,2.5,3080,8451,1.0,0,0,3,7,1540,1540,98052,47.674,-122.154,1550,8125,5371,6575,51,-1530,-326,571,615000.0,0.0022787503569795,0.0013312959301821,0.0012816159679362,0.0102659822678488,0.0011624514676512,0.0014158855915648,1.1040650406504064
1196000007,384900.0,5,2.5,3090,12750,1.0,0,0,3,8,1750,1340,98023,47.3408,-122.335,1760,25919,9660,24159,52,-1330,13169,492,269000.0,0.0031423995118602,0.0024686887970902,0.0020762124190722,0.0095411694340804,0.0018148221474295,0.0054027248960581,1.4308550185873603
3459900230,1680000.0,4,3.75,7620,29536,2.0,0,3,3,11,5980,1640,98006,47.5571,-122.14,2840,20809,21916,17969,15,-4780,-8727,490,760184.5,0.0053906029481363,0.0044883574869756,0.0053055528199723,0.0057252574620352,0.0020822869963376,0.0034831307770064,2.209989811683874
2739200040,302000.0,5,2.0,1540,9629,1.0,0,0,4,7,1540,0,98059,47.4915,-122.143,2260,9600,8089,7340,60,720,-29,465,435000.0,0.0013740062990158,0.0014363056113472,0.0014553839756553,0.0,0.0020658456301423,0.0016390260292699,0.6942528735632184
4167300030,260000.0,4,1.75,1810,7480,1.0,0,0,3,7,1230,580,98023,47.3275,-122.361,1870,9594,5670,7724,43,60,2114,492,269000.0,0.0018406935651997,0.0014482974276262,0.0014592807288336,0.0041297599043034,0.0019282485316438,0.001999835744156,0.966542750929368
6388930570,515700.0,3,2.5,2180,9722,2.0,0,0,3,8,2180,0,98056,47.527,-122.173,2440,9722,7542,7282,26,260,0,404,380000.0,0.0026760253903253,0.0025124173682931,0.0030184039566014,0.0,0.0031634286899645,0.0030724296370317,1.3571052631578948
3047700105,990000.0,4,3.75,3450,4940,2.0,0,0,3,10,2570,880,98103,47.692,-122.338,1880,5387,1490,3507,14,-1570,447,599,550000.0,0.0034883368216701,0.0023702492456225,0.0030536092592086,0.0059708378849663,0.0020597322348094,0.0025906810504689,1.8
7843500080,325000.0,3,2.5,2130,12245,2.0,0,0,3,8,2130,0,98042,47.3406,-122.057,1910,12216,10115,10306,31,-220,-29,546,292000.0,0.001967162243784,0.0011803893231496,0.00211161208199,0.0,0.0017874071086397,0.0015188626931216,1.1130136986301369
3278602490,365000.0,3,2.5,1780,1754,3.0,0,0,3,8,1780,0,98126,47.548,-122.373,1780,1607,-26,-173,13,0,-147,352,396587.5,0.0032730034219434,0.0009769911346688,0.0040494764117999,0.0,0.0035806676134649,0.0009099995186685,0.9203517508746494
3629870200,550000.0,3,2.5,1740,3082,2.0,0,0,3,8,1740,0,98029,47.5489,-122.006,1910,3075,1342,1165,20,170,-7,320,574500.0,0.0023834310448742,0.0011082766908771,0.0025064822817631,0.0,0.0026983880310243,0.0013628071966856,0.9573542210617928
686200490,570000.0,4,1.75,1860,7700,1.0,0,0,4,8,1860,0,98008,47.626,-122.112,1860,7700,5840,5840,56,0,0,283,545000.0,0.0030806688032595,0.0026705223923302,0.0038366020082342,0.0,0.0032518619532151,0.0028655598410767,1.0458715596330277
6072650250,555000.0,4,2.25,2220,8125,1.0,0,0,4,8,1450,770,98006,47.5429,-122.177,1980,8700,5905,6720,55,-240,575,490,760184.5,0.0015704906226853,0.0012346934108097,0.0012864634764146,0.0026880781986385,0.0014517353002635,0.0014562563198595,0.7300859199312798
5288200070,450000.0,3,1.0,1450,3350,1.5,0,0,4,7,1450,0,98126,47.5607,-122.378,1340,4255,1900,2915,101,-110,905,352,396587.5,0.0026662106527067,0.001865975086169,0.0032987307848931,0.0,0.0026955587651926,0.0024094884579557,1.134680240804362
6821600065,478000.0,2,1.0,820,6000,1.0,0,0,3,7,820,0,98199,47.6494,-122.395,1630,6000,5180,4370,81,810,0,316,689900.0,0.0012001112298213,0.0034904988620973,0.0016305104293014,0.0,0.0025890276057053,0.0035946569019808,0.69285403681693
524069020,1050000.0,4,4.0,4550,54013,1.0,0,1,4,9,2300,2250,98075,47.5964,-122.077,3540,39634,49463,36094,31,-1010,-14379,358,739999.5,0.0042088437519945,0.0079332218739135,0.0022656147647159,0.0341530054644808,0.0033151747911861,0.0073531703566716,1.418919877648566
3438500742,399000.0,3,3.0,2240,10479,2.0,0,0,4,7,1710,530,98106,47.5529,-122.356,1530,5244,8239,3714,70,-710,-5235,330,315000.0,0.0045518185937725,0.0057375384158831,0.0043486995862377,0.0053594903428051,0.0034010429865158,0.0031167423267159,1.2666666666666666
98001070,1169000.0,5,4.25,4610,13252,2.0,0,4,3,11,4610,0,98075,47.5878,-121.969,4400,15154,8642,10754,16,-210,1902,358,739999.5,0.0042643449882846,0.0019464028340048,0.0045410800284088,0.0,0.0041205562376324,0.0028114735728163,1.5797307971154035
8656300080,265000.0,3,2.0,1850,16535,1.0,0,0,3,7,1850,0,98014,47.6565,-121.912,1528,13295,14685,11767,28,-322,-3240,123,415000.0,0.0070993292093266,0.0013785859701551,0.0075845161078723,0.0,0.0064530297143436,0.0013780497967804,0.6385542168674698
2767601031,583500.0,4,1.0,1530,3900,1.5,0,0,4,7,1530,0,98107,47.6748,-122.379,1300,3900,2370,2600,112,-230,0,264,529975.0,0.0036647584373278,0.0046204260743675,0.0043964253900749,0.0,0.0032378580323785,0.0042880609388434,1.1009953299683948
2792000010,513000.0,4,2.5,2660,8887,1.0,0,0,4,8,1880,780,98166,47.439,-122.342,1910,9620,6227,7710,53,-750,733,250,392500.0,0.0051241745455666,0.0026019852617605,0.0043878074966157,0.0086047127349748,0.0040420714028738,0.0030236767720961,1.3070063694267515
1115800110,524000.0,3,1.5,1310,9471,1.0,0,0,4,8,1310,0,98052,47.6644,-122.148,2100,9449,8161,7349,50,790,-22,571,615000.0,0.0009692087557283,0.0014919777250923,0.0010902057909068,0.0,0.0015749342464952,0.0016466095944241,0.8520325203252033
7140600190,233500.0,3,1.5,1580,10517,1.0,0,0,4,6,1580,0,98002,47.2903,-122.214,1400,10658,8937,9258,63,-180,141,197,235000.0,0.0049282441414717,0.0071093379264284,0.0052725543523601,0.0,0.0048067514257168,0.0071301700924888,0.9936170212765958
7853220610,457000.0,3,2.5,2050,5694,2.0,0,2,3,8,2050,0,98065,47.5331,-121.855,2680,7187,3644,4507,16,630,1493,305,500000.0,0.0026030093327407,0.0010829138484407,0.0027272243507875,0.0,0.0034757572417013,0.0020814948533178,0.914
3330501545,330000.0,2,1.0,950,3090,1.0,0,0,4,6,950,0,98118,47.551,-122.276,1230,4120,2140,2890,111,280,1030,498,370000.0,0.001124517197419,0.0010721564779416,0.0014301521230231,0.0,0.0015314755580236,0.0014884220991664,0.8918918918918919
3654800040,295000.0,3,2.5,1570,6932,2.0,0,0,3,7,1570,0,98038,47.3902,-122.049,1570,6271,5362,4701,27,0,-661,586,342750.0,0.0012454762240968,0.0004653495814538,0.0013020271816833,0.0,0.0012637248975537,0.0005347503293263,0.8606856309263311
4037000840,554000.0,3,2.0,1910,9001,1.0,0,0,4,7,1910,0,98008,47.6037,-122.119,2040,8700,7091,6660,63,130,-301,283,545000.0,0.0031634824807665,0.0031217366303071,0.0039397364708211,0.0,0.0035665582712682,0.003237710469788,1.01651376146789
5104540360,616000.0,4,2.5,3440,6915,2.0,0,0,3,10,3440,0,98038,47.3538,-122.004,3200,6915,3475,3715,14,-240,0,586,342750.0,0.0027289415356007,0.0004642083606107,0.0028528493662361,0.0,0.0025757450141223,0.0005896664849771,1.7972283005105762
2770603523,530000.0,3,2.5,1410,1250,2.0,0,0,3,8,1140,270,98119,47.6515,-122.375,1720,2825,-160,1105,10,310,1575,184,744975.0,0.0038207965141328,0.001879134095009,0.003896729823314,0.0035303347280334,0.0050110709707493,0.0041189224024179,0.7114332695728045
3623029045,482000.0,3,1.75,2600,105587,1.0,0,0,4,7,1300,1300,98070,47.4464,-122.497,1941,208438,102987,206497,40,-659,102851,116,466250.0,0.0117914901722464,0.0094222907088166,0.0066218081611238,0.0537701120900028,0.0094374483395731,0.0223154145601233,1.033780160857909
7349400100,279950.0,3,1.75,1930,7267,1.0,0,0,4,7,1330,600,98002,47.3217,-122.205,1600,7698,5337,6098,43,-330,431,197,235000.0,0.0060199437930636,0.0049123855387806,0.0044382894231892,0.0286587695834925,0.0054934302008192,0.0051499389540231,1.191276595744681
7888000390,235000.0,3,1.0,1060,7473,1.0,0,0,3,7,1060,0,98198,47.3699,-122.309,1320,7912,6413,6592,61,260,439,275,266750.0,0.002203187971425,0.0025749502445048,0.0026083254796489,0.0,0.0027973213528863,0.003027837583608,0.8809746954076851
1049010300,435000.0,4,2.0,1650,4745,1.0,0,0,3,7,1130,520,98034,47.7359,-122.18,1650,5184,3095,3534,48,0,439,543,446000.0,0.0015365016929455,0.0008943793582144,0.0012521053098129,0.0030340513921628,0.0015883023935235,0.0011243519360368,0.9753363228699552
8025700590,215000.0,3,1.0,970,7275,1.0,0,0,4,7,970,0,98031,47.4006,-122.188,1750,7200,6305,5450,50,780,-75,271,288400.0,0.001852396466315,0.0022115265065511,0.0020946433275892,0.0,0.0033785936169678,0.0031298986173672,0.7454923717059639
7517500310,775000.0,3,1.0,1460,6198,1.5,0,0,4,7,1460,0,98107,47.6626,-122.361,2280,5160,4738,2880,104,820,-1038,264,529975.0,0.0034970897506527,0.007342923284341,0.0041952817447774,0.0,0.005678704856787,0.0056734344729313,1.4623331289211756
6700390090,255950.0,3,2.5,1720,3676,2.0,0,0,3,7,1720,0,98031,47.4039,-122.188,1720,3510,1956,1790,28,0,-166,271,288400.0,0.0032846617753214,0.0011174668643411,0.0037142129107768,0.0,0.0033206748692484,0.0015258255759665,0.8874826629680999
3175200220,410000.0,3,2.5,2150,4332,2.0,0,0,3,8,2150,0,98019,47.7373,-121.969,2140,4332,2182,2192,7,-10,0,190,401250.0,0.0052109084915995,0.000572312367879,0.0055571925580145,0.0,0.0053539217476801,0.0006159413644295,1.0218068535825544
7866500035,299000.0,1,1.0,740,5000,1.0,0,0,3,7,740,0,98118,47.5519,-122.292,1400,4400,4260,3000,97,660,-600,498,370000.0,0.0008759397116737,0.001734881032268,0.0011140132326706,0.0,0.0017431429115716,0.0015895769991098,0.8081081081081081
7504001440,435000.0,2,1.75,1910,12142,1.0,0,0,3,9,1910,0,98074,47.6276,-122.053,2580,12326,10232,9746,44,670,184,435,645000.0,0.0016557884543864,0.0019132012937665,0.0017949626394032,0.0,0.0022900743031472,0.0021444137204899,0.6744186046511628
98020220,750000.0,4,2.5,3210,8938,2.0,0,0,3,10,3210,0,98075,47.582,-121.971,3740,8108,5728,4368,15,530,-830,358,739999.5,0.002969316141517,0.0013127790922377,0.0031620101716252,0.0,0.0035024728019876,0.0015042515328226,1.0135141983204043
2869100080,744000.0,3,2.5,2670,12187,2.0,0,0,3,8,2670,0,98052,47.6677,-122.15,2400,8999,9517,6599,34,-270,-3188,571,615000.0,0.0019754102120569,0.0019198323868335,0.0022220224898635,0.0,0.0017999248531373,0.0015681913155067,1.2097560975609756
5071400104,690000.0,5,3.5,2720,7598,2.0,0,0,3,8,1860,860,98115,47.6931,-122.283,2430,7728,4878,5298,27,-290,130,576,570000.0,0.0025754966116122,0.0024200959056168,0.0022929418073559,0.003511321971893,0.00249391658824,0.0025383970324929,1.2105263157894737
8899210090,360000.0,3,2.25,2130,8466,1.0,0,0,3,7,1290,840,98055,47.4537,-122.211,2250,9682,6336,7432,37,120,1216,260,297225.0,0.0045808224834509,0.0032284217037189,0.0031262874730387,0.0160452322738386,0.00484355323065,0.0049007325790396,1.2112036336109009
3586501135,680000.0,3,2.25,2270,23900,1.0,0,0,3,9,1820,450,98177,47.7506,-122.372,2520,28300,21630,25780,45,250,4400,254,557000.0,0.0038430283740773,0.0078931133741705,0.0038964486653592,0.0036411302068161,0.0045380875202593,0.0095192989490424,1.220825852782765
5493110080,1825000.0,3,3.75,6030,39317,2.0,0,0,3,11,4440,1590,98004,47.6055,-122.21,4040,12333,33287,8293,29,-1990,-26984,315,1150000.0,0.0065766512520722,0.0095393075176546,0.0058282248854701,0.0102534339330624,0.0047987836746329,0.0030591196640896,1.5869565217391304
121039156,249000.0,3,1.0,1030,24750,1.0,0,2,3,5,1030,0,98023,47.3343,-122.362,2810,28800,23720,25990,77,1780,4050,492,269000.0,0.0010474665039534,0.0047921606061163,0.001221999309511,0.0,0.0028975285422028,0.0060032592695117,0.9256505576208178
7987400316,255000.0,1,0.5,880,1642,1.0,0,0,3,6,500,380,98126,47.5732,-122.372,1410,2992,762,1582,110,530,1350,352,396587.5,0.0016181140512978,0.000914606295967,0.001137493374101,0.0036440352896049,0.0028363715365087,0.0016942865960525,0.6429854697891386
4309720160,785000.0,3,2.5,2930,33981,2.0,0,2,3,9,2930,0,98059,47.5151,-122.12,3720,35230,31051,31510,20,790,1249,465,435000.0,0.0026141808156601,0.0050687611360671,0.0027690097718638,0.0,0.0034004184708537,0.0060148840636645,1.8045977011494247
6117502745,430000.0,2,1.75,1840,14874,1.0,0,2,3,8,1300,540,98166,47.4382,-122.348,2920,15084,13034,12164,68,1080,210,250,392500.0,0.0035445417909182,0.004354892402771,0.0030341222051066,0.005957108816521,0.0061795018305716,0.0047410748888044,1.095541401273885
2922701420,490000.0,4,2.25,2020,4960,2.0,0,0,3,7,1710,310,98117,47.6867,-122.369,1590,4550,2940,2960,82,-430,-410,548,545000.0,0.0021769634162375,0.001952338535502,0.0023378285264297,0.0015780096716721,0.0018839308988364,0.0017886872411563,0.8990825688073395
9831200186,690000.0,2,2.5,1990,1756,3.0,0,0,3,9,1780,210,98102,47.6264,-122.323,1955,1438,-234,-517,15,-35,-318,104,710000.0,0.0088954847592184,0.0046834659781936,0.0097665894850044,0.005065733928356,0.0096179863724694,0.0041855374835547,0.971830985915493
8011100095,415000.0,3,2.5,2090,6045,2.0,0,0,3,8,2090,0,98056,47.4947,-122.174,2040,6392,3955,4352,20,-50,347,404,380000.0,0.0025655472778806,0.001562185043338,0.0028937909492188,0.0,0.0026448338227572,0.0020200545402084,1.0921052631578947
3223049131,270000.0,4,2.5,2490,11650,1.0,0,0,3,7,1390,1100,98148,47.4416,-122.332,2010,10495,9160,8485,30,-480,-1155,56,279000.0,0.0274017827665896,0.0231600668759356,0.0165871121718377,0.1555869872701555,0.0222788738638882,0.0212569016572079,0.967741935483871
8648210140,265000.0,3,2.25,1510,6071,1.0,0,0,4,7,1150,360,98042,47.3619,-122.077,1510,7271,4561,5761,35,0,1200,546,292000.0,0.0013945610272835,0.0005852301821838,0.0011400722508396,0.0048602673147023,0.0014130810125895,0.0009040316504328,0.9075342465753424
7745000090,565000.0,4,2.25,2470,7447,2.0,0,0,3,8,2470,0,98155,47.7514,-122.286,2270,7400,4977,5130,36,-200,-47,442,377225.0,0.0031359504342085,0.0016351762936106,0.0037922404925306,0.0,0.0029875378871131,0.0017035284909384,1.4977798396182649
662310400,515000.0,4,3.0,3590,8249,2.0,0,0,3,9,3590,0,98023,47.2846,-122.341,2860,7995,4659,5135,23,-730,-254,492,269000.0,0.0036508783972745,0.0015971932460546,0.0042592014768395,0.0,0.002949085989573,0.0016665297867967,1.9144981412639408
6666830430,775950.0,4,2.5,2970,4400,2.0,0,0,3,8,2970,0,98052,47.705,-122.114,3010,4892,1430,1882,6,40,492,571,615000.0,0.0021973664156588,0.0006931371545144,0.0024716879381628,0.0,0.0022574057533097,0.0008524938232535,1.2617073170731707
8096800110,345000.0,3,2.25,2730,9388,1.0,0,0,3,7,1390,1340,98030,47.3785,-122.185,2255,5701,6658,3446,45,-475,-3687,253,283000.0,0.0054770885161704,0.0031439695596232,0.0030357298855595,0.0330374753451676,0.0046307704944964,0.0026274807478618,1.2190812720848057
4139420070,1195000.0,5,3.25,5180,19606,1.0,0,0,3,11,2610,2570,98006,47.555,-122.114,4050,15296,14426,11246,27,-1130,-4310,490,760184.5,0.0036644781195992,0.0029793721861337,0.0023156342575464,0.0089718973642869,0.0029694585687209,0.0025603329504104,1.5719868005727555
4139420430,1365000.0,5,3.5,4210,17258,2.0,0,3,3,12,4210,0,98006,47.553,-122.114,4630,17909,13048,13279,25,420,651,490,760184.5,0.0029782727574348,0.0026225647856929,0.0037351801625557,0.0,0.0033947143637476,0.0029977120037199,1.7956167219931478
4449800595,545000.0,3,1.75,1400,4000,1.5,0,0,4,7,1400,0,98117,47.6902,-122.388,1050,4330,2600,3280,95,-350,330,548,545000.0,0.0015087865261052,0.0015744665608887,0.0019140116590653,0.0,0.0012441053105523,0.0017022012646608,1.0
2273600410,546000.0,3,3.0,1530,9999,1.0,0,0,4,7,1150,380,98033,47.6869,-122.186,1530,8556,8469,7026,37,0,-1443,431,678000.0,0.0014919420502404,0.0022077540987189,0.001296412994342,0.0027447524666657,0.0016082882557115,0.001999244324901,0.8053097345132744
8562890370,399950.0,4,2.5,3110,5868,2.0,0,0,3,8,3110,0,98042,47.3781,-122.126,2950,5924,2758,2974,19,-160,56,546,292000.0,0.0028722415859945,0.0005656614575942,0.0030831519131403,0.0,0.0027606549583702,0.0007365539124142,1.3696917808219178
6096500105,1545000.0,4,2.25,2640,3000,2.0,0,0,3,7,2080,560,98109,47.6313,-122.344,1910,3000,360,1090,112,-730,0,109,736000.0,0.0117872403123618,0.0076007479135946,0.0116545545214628,0.0123076923076923,0.0090870165088729,0.0076331216414264,2.099184782608696
2484700145,559000.0,4,1.75,2250,8458,1.0,0,0,3,8,1450,800,98136,47.5235,-122.383,1950,7198,6208,5248,66,-300,-1260,263,489950.0,0.004954244796942,0.0053757905106937,0.0040775006327156,0.0081180362470318,0.0044340351994178,0.0047569985308686,1.1409327482396163
1995200200,415000.0,3,1.0,1510,6083,1.0,0,0,4,6,860,650,98115,47.6966,-122.324,1510,5712,4573,4202,80,0,-371,576,570000.0,0.0014297793689465,0.0019375419049575,0.0010601773947989,0.0026539061415471,0.001549717715326,0.0018762065022774,0.7280701754385965
4077800088,699950.0,4,2.0,2070,7830,1.0,0,1,5,7,1180,890,98125,47.7058,-122.278,2390,7830,5760,5440,79,320,0,402,425000.0,0.002939305471936,0.0025317659018664,0.002061808835375,0.0067457460112934,0.0035823598008267,0.0026601635915673,1.646941176470588
3904990030,561000.0,4,2.5,2570,5250,2.0,0,0,3,8,2570,0,98029,47.5763,-122.0,2260,5392,2680,3132,30,-310,142,320,574500.0,0.0035203550490384,0.0018878820983467,0.0037021031403053,0.0,0.003192857041945,0.0023896768795216,0.9765013054830288
9551201240,1465000.0,4,2.5,2800,4000,2.0,0,0,3,9,2800,0,98103,47.6695,-122.339,1770,4200,1200,2430,9,-1030,200,599,550000.0,0.002831113942225,0.0019192301583988,0.0033268894652856,0.0,0.001939215987028,0.0020198367202468,2.663636363636364
7695470120,610000.0,3,2.5,2260,33042,1.0,0,0,3,9,1660,600,98077,47.7634,-122.086,2600,40115,30782,37515,34,340,7073,196,652475.0,0.0040382742631489,0.0030613646003521,0.003166579236015,0.0169395821569734,0.0047701170513337,0.0044854631968946,0.934901720372428
7922900460,660000.0,3,1.75,2030,9032,2.0,0,2,4,7,2030,0,98008,47.586,-122.117,2350,8937,7002,6587,57,320,-95,283,545000.0,0.0033622353067832,0.0031324880840944,0.0041872591810298,0.0,0.0041085352634707,0.0033259101687926,1.211009174311927
7625702264,399000.0,2,2.0,1110,1155,3.0,0,0,3,7,980,130,98136,47.5496,-122.388,1110,1089,45,-21,12,0,-66,263,489950.0,0.0024440940998247,0.0007341023929831,0.0027558280138353,0.0013191808901426,0.0025239892673609,0.0007196959433336,0.8143688131441984
255370020,345000.0,4,2.5,2020,3600,2.0,0,0,3,7,2020,0,98038,47.3535,-122.017,2210,3800,1580,1590,8,190,200,586,342750.0,0.0016024598552074,0.0002416702961964,0.0016752196859875,0.0,0.0017788739003782,0.0003240394277531,1.0065645514223194
8150600195,450000.0,4,2.75,1540,4840,1.0,0,2,4,7,850,690,98126,47.5491,-122.375,1180,4840,3300,3660,91,-360,0,352,396587.5,0.0028316995897713,0.0026959162438979,0.0019337387359718,0.0066168009205983,0.0023737010021846,0.0027407577289084,1.134680240804362
1823069213,249950.0,3,2.0,1550,15040,1.0,0,0,4,6,1550,0,98059,47.4873,-122.099,1510,41416,13490,39906,62,-40,26376,465,435000.0,0.0013829284178406,0.0022434350809702,0.0014648345209518,0.0,0.0013802773900508,0.0070710314612753,0.5745977011494253
1441000350,440000.0,4,3.5,3180,4869,2.0,0,0,3,8,2390,790,98055,47.4482,-122.206,2850,4500,1689,1650,13,-330,-369,260,297225.0,0.0068389744119127,0.0018567428862989,0.0057921140004362,0.0150901589242053,0.00613516742549,0.0022777625083328,1.4803599966355454
3630110510,571000.0,3,2.5,1920,3867,2.0,0,0,3,8,1920,0,98029,47.5538,-121.994,2190,3841,1947,1651,15,270,-26,320,574500.0,0.0026299928771026,0.0013905600141537,0.0027657735522904,0.0,0.0030939632397609,0.0017022902251933,0.9939077458659704
7229900145,430000.0,4,2.5,2010,16020,1.5,0,0,5,8,2010,0,98059,47.4821,-122.108,1420,16020,14010,14600,58,-590,0,465,435000.0,0.0017933458837804,0.002389616356193,0.0018995596045891,0.0,0.0012980092012398,0.0027351246863441,0.9885057471264368
3904901710,435500.0,3,2.25,1450,4789,2.0,0,0,3,7,1450,0,98029,47.5665,-122.018,1560,4490,3339,2930,35,110,-299,320,574500.0,0.0019861925373952,0.0017221080702824,0.0020887352348026,0.0,0.0022039190201036,0.0019899201018271,0.7580504786771105
1787600146,427000.0,4,2.5,1600,14000,1.0,0,0,3,8,1310,290,98125,47.7258,-122.326,1600,10200,12400,8600,70,0,-3800,402,425000.0,0.0022719269348297,0.0045267844988671,0.0022889572663909,0.0021980520710956,0.0023982325026455,0.0034653472074057,1.0047058823529411
7211400615,217450.0,3,1.0,1040,5000,1.0,0,0,3,7,1040,0,98146,47.5122,-122.358,1440,5000,3960,3560,61,400,0,281,312000.0,0.0022750241721318,0.0019747149597691,0.0026852707734096,0.0,0.0033307273475845,0.0021527060807058,0.6969551282051282
9165100260,717000.0,3,1.5,1310,3880,1.0,0,0,3,7,1090,220,98117,47.6821,-122.392,1570,3880,2570,2310,64,260,0,548,545000.0,0.0014117931065699,0.001527232564062,0.0014901947917008,0.0011198778315092,0.0018602336548259,0.0015252981309201,1.3155963302752294
6762700340,852000.0,3,3.0,2400,4000,2.0,0,0,3,7,1860,540,98102,47.6288,-122.321,1750,3940,1600,2190,115,-650,-60,104,710000.0,0.010728222825188,0.0106684874218533,0.0102055373270271,0.0130261729586298,0.0086094507170442,0.0114680234250387,1.2
1455100355,1675000.0,3,2.5,3490,8343,2.0,1,4,4,9,2150,1340,98125,47.7265,-122.281,2990,13104,4853,10114,81,-500,4761,402,425000.0,0.0049556406265974,0.0026976402195749,0.0037566855898782,0.0101565164664418,0.0044816969893188,0.0044519519417495,3.941176470588236
1247600105,5110800.0,5,5.25,8010,45517,2.0,1,4,3,12,5990,2020,98033,47.6767,-122.211,3430,26788,37507,23358,21,-4580,-18729,431,678000.0,0.0078107554394939,0.0100500393350727,0.0067526207270509,0.0145905262701703,0.0036055089654186,0.0062594386366817,7.5380530973451325
4054500590,910000.0,4,3.5,4040,50479,2.0,0,0,3,11,4040,0,98077,47.7196,-122.048,3770,40899,46439,37129,33,-270,-9580,196,652475.0,0.0072188619571335,0.0046769149464673,0.0077066145262053,0.0,0.006916669724434,0.0045731262442925,1.3946894517031303
7010700580,585000.0,2,2.0,1370,7920,1.0,0,0,3,8,950,420,98199,47.6589,-122.397,1370,4680,6550,3310,71,0,-3240,316,689900.0,0.0020050638839697,0.0046074584979685,0.0018890059851663,0.0023286759813705,0.0021760538771879,0.002803832383545,0.8479489781127699
1221039066,310000.0,4,2.5,3140,22100,1.0,0,0,4,8,1820,1320,98023,47.319,-122.362,2700,25500,18960,22800,60,-440,3400,492,269000.0,0.0031932474004016,0.004279060581623,0.002159260915835,0.0093987639201389,0.0027841021579885,0.0053153858115468,1.1524163568773234
5101402618,935000.0,4,3.0,3680,7105,2.0,0,2,3,10,2890,790,98115,47.6956,-122.311,1580,6815,3425,5235,12,-2100,-290,576,570000.0,0.0034844954157107,0.0022630667819699,0.0035626891522895,0.003225516695111,0.0016215589339173,0.0022385061822515,1.6403508771929824
7287700059,367950.0,3,1.75,2290,8234,1.0,0,0,4,7,1250,1040,98133,47.7611,-122.351,1660,7200,5944,5540,70,-630,-1034,484,375000.0,0.0029328968568054,0.002397267452829,0.0018912057420032,0.0086779479990654,0.0022122095308916,0.002212536910186,0.9812
6716700240,725000.0,4,1.0,1600,4500,1.5,0,0,4,7,1600,0,98115,47.6804,-122.316,1720,4500,2900,2780,94,120,0,576,570000.0,0.0015149980068307,0.0014333287148296,0.0019724230600911,0.0,0.0017652413710999,0.0014781038620883,1.2719298245614037
282500010,685000.0,4,2.25,3133,16197,2.0,0,0,3,9,2533,600,98166,47.4255,-122.338,3090,15588,13064,12498,55,-43,-609,250,392500.0,0.0060353529516015,0.0047422476971683,0.0059118704196424,0.0066190097961344,0.0065392673481048,0.0048994878922489,1.7452229299363058
3359500096,645000.0,3,2.0,2130,4000,2.0,0,0,3,7,2130,0,98115,47.6741,-122.323,2010,4000,1870,1990,112,-120,0,576,570000.0,0.0020168410965934,0.0012740699687375,0.0026257881987462,0.0,0.0020628692766923,0.001313870099634,1.131578947368421
1442880610,533380.0,4,2.75,2790,6685,2.0,0,0,3,8,2790,0,98045,47.4838,-121.773,2790,6444,3895,3654,6,0,-241,218,404750.0,0.0061819350121312,0.0006061397376507,0.0065807319000389,0.0,0.0066782358925258,0.0009109609209922,1.3178011117974058
3591000030,728000.0,4,2.5,2650,13684,2.0,0,0,3,9,2650,0,98052,47.6278,-122.108,2650,12032,11034,9382,26,0,-1652,571,615000.0,0.0019606131318168,0.0021556565505399,0.0022053781266436,0.0,0.0019874170253391,0.0020967305154102,1.183739837398374
7229100180,302200.0,4,1.5,1730,10396,1.0,0,0,3,7,1730,0,98058,47.4497,-122.168,1510,10396,8666,8886,56,-220,0,451,335000.0,0.0018667748604774,0.0011776472226114,0.002120404666361,0.0,0.0016913480267793,0.0016708145059999,0.902089552238806
2919200280,720168.0,4,2.25,2120,3794,2.0,0,0,4,7,1420,700,98117,47.6893,-122.359,1420,3840,1674,2420,94,-700,46,548,545000.0,0.0022847338823879,0.0014933815330029,0.0019413546827662,0.0035632476457113,0.001682504324747,0.0015095734079209,1.3214091743119265
9413600380,725000.0,4,1.75,2190,9400,1.0,0,0,4,7,1450,740,98033,47.6531,-122.196,1980,9000,7210,7020,58,-210,-400,431,678000.0,0.0021355248954421,0.0020754964024361,0.0016346076885181,0.0053450442771911,0.0020813142132737,0.0021029919266139,1.0693215339233038
2922701085,543000.0,2,1.0,1070,4700,1.0,0,0,5,7,1070,0,98117,47.6887,-122.368,1370,4700,3630,3330,110,300,0,548,545000.0,0.001153143987809,0.0018499982090442,0.0014628517679999,0.0,0.0016232612147207,0.0018476549524032,0.9963302752293578
7771300085,411500.0,3,1.0,1130,8159,1.0,0,0,4,7,1130,0,98133,47.7362,-122.333,1570,8162,7029,6592,66,440,3,484,375000.0,0.0014472373136201,0.0023754317643469,0.0017096499907709,0.0,0.0020922704599396,0.0025081564251303,1.0973333333333333
2023049372,339950.0,4,2.25,2670,9040,1.0,0,0,3,8,2170,500,98148,47.4666,-122.326,1880,2648,6370,768,65,-790,-6392,56,279000.0,0.0293826345328491,0.0179714167002968,0.0258949880668257,0.0707213578500707,0.0208379516736865,0.0053633421237052,1.2184587813620071
2112700185,435000.0,3,2.5,3110,6000,1.0,0,2,3,8,1560,1550,98106,47.5331,-122.353,2060,6000,2890,3940,53,-1050,0,330,315000.0,0.0063197124226038,0.0032851637079204,0.0039672347102519,0.0156739811912225,0.0045791820602762,0.0035660667353728,1.380952380952381
2780400035,665000.0,4,2.5,2800,5900,1.0,0,0,3,8,1660,1140,98115,47.6809,-122.286,2580,5900,3100,3320,57,-220,0,576,570000.0,0.0026512465119538,0.0018792532038878,0.0020463889248445,0.004654543079021,0.0026478620566498,0.0019379583969602,1.1666666666666667
3326059191,410000.0,4,2.0,1580,9581,1.0,0,0,3,7,1580,0,98033,47.692,-122.165,1580,10552,8001,8972,67,0,971,431,678000.0,0.001540698326392,0.0021154607480574,0.0017811587226611,0.0,0.0016608466954406,0.00246564120107,0.6047197640117994
8649400410,375000.0,3,1.75,2140,13598,1.5,0,0,4,7,1620,520,98014,47.7139,-121.321,930,10150,11458,9220,50,-1210,-3448,123,415000.0,0.0082121970313291,0.001133717086312,0.0066415762674341,0.0311937612477504,0.003927563896819,0.001052065094947,0.9036144578313252
8911000445,329000.0,2,1.0,940,7700,1.0,0,0,4,6,940,0,98133,47.7067,-122.354,1290,7375,6760,6085,104,350,-325,484,375000.0,0.0012038965263742,0.002241797350836,0.0014221867179864,0.0,0.0017191266836447,0.0022663138489753,0.8773333333333333
3286800370,590000.0,5,3.25,4020,40341,1.0,0,0,5,8,2170,1850,98027,47.4952,-122.068,2650,53437,36321,50787,50,-1370,13096,411,571000.0,0.0038875172980014,0.0029807440872968,0.0024969248701771,0.0112114417308041,0.0027126652806482,0.0045624400793929,1.0332749562171628
3886902870,800000.0,4,2.5,2680,7200,1.0,0,0,3,8,1380,1300,98033,47.6835,-122.187,1950,8520,4520,6570,68,-730,1320,431,678000.0,0.0026133364017283,0.0015897419252702,0.0015556955932104,0.0093899426491195,0.0020497791494362,0.0019908323571945,1.1799410029498525
3131201563,435000.0,2,1.0,1060,3036,1.5,0,0,4,6,1060,0,98105,47.6578,-122.324,1730,5535,1976,3805,77,670,2499,229,675000.0,0.0021523629290004,0.0025887936613779,0.0027333536185991,0.0,0.0037239939296746,0.0048937477620055,0.6444444444444445
2561360210,562100.0,3,2.25,2090,12112,2.0,0,0,3,8,2090,0,98052,47.7015,-122.13,1760,12112,10022,10352,37,-330,0,571,615000.0,0.0015462948850932,0.0019080175489725,0.0017393359564849,0.0,0.0013199448923007,0.0021106715427733,0.9139837398373984
1926059039,799950.0,4,2.5,3320,7429,2.0,0,0,3,9,3320,0,98034,47.7189,-122.225,1840,7429,4109,5589,6,-1480,0,543,446000.0,0.0030916276488357,0.0014002832986671,0.0036787518836982,0.0,0.0017711978206565,0.0016112674638923,1.793609865470852
3356404330,206000.0,4,2.0,1720,7560,1.0,0,0,3,7,1720,0,98001,47.2845,-122.25,1750,7988,5840,6238,61,30,428,358,260000.0,0.0025177265514757,0.0014109824076996,0.0027824241385,0.0,0.0026678618687838,0.0019921585566676,0.7923076923076923
3331001765,335000.0,3,1.0,2130,3825,1.5,0,0,3,7,2130,0,98118,47.5506,-122.281,1780,5150,1695,3370,103,-350,1325,498,370000.0,0.0025212859268448,0.001327183989685,0.0032065516021467,0.0,0.0022162817018553,0.0018605276239581,0.9054054054054054
6632300212,366750.0,3,3.0,1571,2017,3.0,0,0,3,8,1571,0,98125,47.7338,-122.309,1520,1497,446,-23,12,-51,-520,402,425000.0,0.0022307482591359,0.0006521803095867,0.0027450014240459,0.0,0.0022783208775132,0.0005085906636751,0.8629411764705882
880000189,209000.0,3,2.0,1230,1340,2.0,0,0,3,7,1020,210,98106,47.526,-122.361,1260,1312,110,52,17,30,-28,330,315000.0,0.0024994361028304,0.0007336865614355,0.0025939611567032,0.0021235716452624,0.0028008589300718,0.0007797799261348,0.6634920634920635
5019500215,495000.0,2,1.75,1280,4000,1.0,0,0,4,7,730,550,98116,47.5798,-122.383,2250,5382,2720,3132,91,970,1382,329,565500.0,0.0020973566751653,0.0024416908953619,0.0015626270972382,0.0038426605184098,0.0040356645125186,0.0033201665882172,0.8753315649867374
3905040800,533600.0,3,2.5,1930,5080,2.0,0,0,4,8,1930,0,98029,47.5694,-122.001,2190,5085,3150,2895,30,260,5,320,574500.0,0.0026436907566708,0.0018267506780193,0.0027801786228752,0.0,0.0030939632397609,0.0022536177545192,0.9288076588337684
8960200630,248000.0,3,1.0,1180,6947,1.0,0,0,4,7,1180,0,98031,47.4233,-122.177,1760,8657,5767,6897,52,580,1710,271,288400.0,0.0022534307528368,0.0021118178200702,0.0025481228108817,0.0,0.0033978998662076,0.0037632683792428,0.8599167822468793
4435000520,245990.0,3,1.0,1040,8410,1.0,0,0,3,7,1040,0,98188,47.453,-122.289,1350,8410,7370,7060,78,310,0,135,265000.0,0.0042653192632481,0.0061456526997391,0.0051591652073835,0.0,0.0061021361996799,0.0063824248812876,0.9282641509433962
7224000950,238950.0,2,1.0,810,4838,1.0,0,0,3,5,810,0,98055,47.4909,-122.203,890,4838,4028,3948,82,80,0,260,297225.0,0.0017420029162419,0.0018449213563184,0.001963017715629,0.0,0.0019158943890126,0.0024488477811809,0.8039364118092355
7174800760,667000.0,5,2.0,1900,5470,1.0,0,0,3,7,1180,720,98105,47.6666,-122.303,1300,3250,3570,1950,90,-600,-2220,229,675000.0,0.00385800902368,0.0046642626244194,0.0030427898773085,0.0068781047000382,0.002798376941374,0.0028734742956672,0.988148148148148
587550340,604000.0,3,2.5,3240,33151,2.0,0,2,3,10,3240,0,98023,47.3256,-122.378,4050,24967,29911,20917,25,810,-8184,492,269000.0,0.0032949431774845,0.0064187844950853,0.0038439589930251,0.0,0.0041761532369827,0.0052042838257604,2.245353159851301
2112700600,415000.0,3,2.25,1640,5880,1.0,0,0,3,7,1240,400,98106,47.5323,-122.351,1200,4760,4240,3560,43,-440,-1120,330,315000.0,0.0033325814704406,0.003219460433762,0.0031534429748156,0.0040448983719284,0.0026674846953065,0.0028290796100624,1.3174603174603174
5515600163,420000.0,5,2.25,3070,64033,1.0,0,0,3,9,2730,340,98001,47.3238,-122.292,1560,28260,60963,26700,37,-1510,-35773,358,260000.0,0.0044938491354829,0.0119509836656389,0.0044162894756424,0.0052315740883212,0.0023782082944587,0.0070478719092924,1.6153846153846154
7600065,465000.0,3,2.25,1530,1245,2.0,0,0,3,9,1050,480,98122,47.6018,-122.297,1530,2307,-285,777,6,0,1062,289,574000.0,0.0029595871279238,0.0012293855738268,0.0024295769759402,0.0056610449345441,0.0030927960088781,0.0022437814574367,0.8101045296167247
6798100610,425000.0,3,1.5,1190,8100,1.0,0,0,3,7,830,360,98125,47.7146,-122.311,1256,8100,6910,6844,73,66,0,402,425000.0,0.0016897456577796,0.0026190681743445,0.0014502553672553,0.0027286163641186,0.0018826125145767,0.0027518933705869,1.0
3226049478,430000.0,4,1.0,1350,9000,1.5,0,0,4,7,1350,0,98103,47.6953,-122.332,1940,8000,7650,6060,56,590,-1000,599,550000.0,0.0013650013650013,0.0043182678563974,0.0016040359921913,0.0,0.0021254683699629,0.0038473080385654,0.7818181818181819
8581400015,189900.0,2,1.0,1000,4179,1.0,0,0,5,5,1000,0,98002,47.297,-122.227,1010,6327,3179,5317,106,10,2148,197,235000.0,0.003119141861691,0.0028249427778401,0.0033370597166836,0.0,0.0034677278142671,0.0042327440584703,0.8080851063829787
8682282210,541500.0,2,2.5,1900,3690,2.0,0,0,3,8,1900,0,98053,47.7082,-122.019,1900,5153,1790,3253,14,0,1463,400,635000.0,0.0018128629303879,0.0002617824075979,0.0018678248491485,0.0,0.001919938561966,0.000443523981797,0.852755905511811
1558100398,350000.0,3,1.75,1680,250470,1.0,0,0,4,7,1070,610,98019,47.7624,-121.93,1680,360000,248790,358320,80,0,109530,190,401250.0,0.0040717796585521,0.033090276727298,0.0027656725753839,0.0237261765849863,0.0042030787551881,0.0511862629719853,0.8722741433021807
7701990300,862500.0,4,2.75,3280,24440,2.0,0,0,3,10,3280,0,98077,47.7073,-122.07,3490,25138,21160,21648,24,210,698,196,652475.0,0.0058608582226232,0.0022643832344472,0.0062568553579092,0.0,0.0064029648112134,0.0028108082723055,1.3218897275757693
1386800054,283450.0,5,2.75,2770,6116,1.0,0,0,3,7,1490,1280,98168,47.4847,-122.291,1920,6486,3346,4566,41,-850,370,264,237000.0,0.007110403778525,0.0020409191611141,0.004551981181071,0.0205655526992287,0.0049251985470664,0.0025142936001807,1.195991561181435
1450100330,237950.0,3,1.75,1310,7314,1.0,0,0,5,6,1310,0,98002,47.2888,-122.221,1010,7314,6004,6304,60,-300,0,197,235000.0,0.0040860758388152,0.0049441568502327,0.0043715482288555,0.0,0.0034677278142671,0.0048930441036276,1.0125531914893615
920069053,201000.0,3,1.0,960,15273,1.0,0,0,4,7,960,0,98022,47.238,-122.039,1930,51400,14313,49470,57,970,36127,233,280000.0,0.0022424981429312,0.000883010911686,0.0023845955129861,0.0,0.004597865446922,0.0042844751459597,0.7178571428571429
9818700320,491000.0,3,2.0,2005,7000,1.0,0,0,3,7,1605,400,98122,47.6039,-122.298,1750,4500,4995,2750,40,-255,-2500,289,574000.0,0.0038784131970504,0.0069122080456126,0.0037137819489372,0.0047175374454534,0.0035375117748606,0.004376686848056,0.8554006968641115
4083305633,615000.0,3,3.25,1470,1152,3.0,0,0,3,8,1470,0,98103,47.6516,-122.337,1470,1506,-318,36,17,0,354,599,550000.0,0.0014863348196681,0.0005527382856188,0.0017466169692749,0.0,0.0016105353112606,0.0007242557382599,1.1181818181818182
7214700160,610000.0,3,3.0,2480,45302,1.0,0,0,4,8,1620,860,98077,47.7591,-122.073,1260,14100,42822,12840,44,-1220,-31202,196,652475.0,0.0044313806073493,0.0041972622457826,0.0030902761218942,0.0242800677583286,0.0023116721094925,0.0015765930718238,0.934901720372428
1001200035,272450.0,3,1.0,1350,7973,1.5,0,0,3,7,1350,0,98188,47.4323,-122.292,1310,7491,6623,6181,66,-40,-482,135,265000.0,0.0055367125051778,0.0058263126010726,0.0066969932980459,0.0,0.0059213321641339,0.0056849874893847,1.0281132075471695
2979800764,390000.0,3,2.0,1463,868,3.0,0,0,3,7,1463,0,98115,47.6843,-122.317,1484,4320,-595,2836,17,21,3452,576,570000.0,0.0013852763024958,0.000276473183216,0.0018035343355708,0.0,0.001523033834135,0.0014189797076047,0.6842105263157895
9144100126,489900.0,3,1.0,1680,8910,1.0,0,0,4,7,1680,0,98117,47.7011,-122.375,1620,7182,7230,5562,80,-60,-1728,548,545000.0,0.0018105438313262,0.0035071242643797,0.0022968139908783,0.0,0.0019194767648522,0.0028233740145021,0.8988990825688074
1546600120,830000.0,4,2.25,3010,12202,1.0,0,0,4,9,3010,0,98005,47.6387,-122.174,2480,10143,9192,7663,61,-530,-2059,168,765475.0,0.0067436926310035,0.0036445247303195,0.0082939988371868,0.0,0.0057487117554201,0.0032870069408572,1.0842940657761522
5423600100,604000.0,6,3.5,2580,13572,1.0,0,0,3,8,1290,1290,98052,47.6796,-122.113,2020,11656,10992,9636,33,-560,-1916,571,615000.0,0.0019088233509763,0.0021380130593341,0.0010735614276868,0.0085994267048863,0.0015149367513906,0.0020312076868036,0.9821138211382112
7227501645,230000.0,3,2.0,1440,5600,1.0,0,0,4,6,720,720,98056,47.4947,-122.185,1120,5700,4160,4580,78,-320,100,404,380000.0,0.0017676497991139,0.0014471854826622,0.000996904059061,0.0077917861587576,0.0014520656281804,0.0018013627783461,0.6052631578947368
2895800390,359800.0,5,2.5,2170,2752,2.0,0,0,3,8,2170,0,98106,47.5165,-122.346,1800,2752,582,952,6,-370,0,330,315000.0,0.0044095742627171,0.0015067950873661,0.0055185252059274,0.0,0.0040012270429598,0.0016356359426243,1.1422222222222222
8899000430,325500.0,4,1.75,2290,8142,1.0,0,0,4,7,1490,800,98055,47.4564,-122.211,1840,8142,5852,6302,51,-450,0,260,297225.0,0.0049249218249308,0.0031048676484383,0.0036109832052928,0.015281173594132,0.0039609501975093,0.0041212316317435,1.0951299520565227
9407001860,372000.0,4,1.75,1960,9300,1.0,0,0,5,7,1340,620,98045,47.4487,-121.772,1500,9752,7340,8252,41,-460,452,218,404750.0,0.004342864739705,0.0008432460075021,0.0031606382602337,0.0226691042047532,0.0035904494045838,0.0013785988363619,0.9190858554663373
1443500385,155000.0,2,1.0,910,6232,1.0,0,0,3,6,910,0,98118,47.5328,-122.272,1070,6232,5322,5162,77,160,0,498,370000.0,0.0010771691048961,0.0021623557186189,0.0013699351915274,0.0,0.0013322592252725,0.0022514190587392,0.4189189189189189
3141600210,186000.0,3,2.0,1340,4320,1.0,0,0,3,5,920,420,98002,47.299,-122.228,980,6480,2980,5500,108,-360,2160,197,235000.0,0.0041796500946659,0.0029202567121965,0.0030700949393489,0.0200611387084447,0.0033647259980017,0.0043351006004248,0.7914893617021277
5379803372,495000.0,4,2.5,3390,7870,2.0,0,0,3,8,3390,0,98188,47.4536,-122.274,1960,10069,4480,8109,6,-1430,2199,135,265000.0,0.0139033002907799,0.0057510447974967,0.0168168942817598,0.0,0.0088593977417575,0.007641454950022,1.8679245283018868
7625701795,885000.0,4,3.5,3310,6000,2.0,0,2,3,8,2200,1110,98136,47.5511,-122.391,1420,6000,2690,4580,10,-1890,0,263,489950.0,0.0072882445679458,0.0038135189245876,0.0061865526841202,0.0112637752927566,0.0032288871708581,0.0039652669054197,1.8063067659965304
6821101731,549000.0,3,2.25,1230,1380,3.0,0,0,3,8,1230,0,98199,47.6521,-122.4,1760,5664,150,3904,7,530,4284,316,689900.0,0.0018001668447319,0.0008028147382823,0.0024457656439521,0.0,0.0027955144699641,0.0033933561154699,0.7957675025365996
4364200125,530000.0,2,1.75,2120,7680,1.0,0,0,5,6,1130,990,98126,47.5304,-122.374,1220,7680,5560,6460,72,-900,0,352,396587.5,0.003898183850854,0.0042778175109786,0.0025707350254684,0.0094936708860759,0.0024541654429366,0.004348970941739,1.3364011725029157
3755000020,342500.0,3,1.0,940,10500,1.0,0,0,4,7,940,0,98034,47.7268,-122.229,1660,10500,9560,8840,54,720,0,543,446000.0,0.0008753403584053,0.0019791324049003,0.0010415743285169,0.0,0.0015979284686358,0.0022773332037783,0.7679372197309418
7327500270,445000.0,3,2.25,1190,13630,1.0,0,0,3,7,1190,0,98045,47.4813,-121.735,1630,14405,12440,12775,36,440,775,218,404750.0,0.0026367393062495,0.001235854094866,0.002806835469909,0.0,0.0039016216863144,0.0020363736913242,1.099444101297097
6403510090,437500.0,4,2.5,2680,7513,2.0,0,0,3,8,2680,0,98059,47.4956,-122.161,2640,7243,4833,4603,22,-40,-270,465,435000.0,0.0023911278450406,0.0011206733885192,0.0025327461394522,0.0,0.002413200205122,0.0012366109927085,1.0057471264367817
1974300060,570000.0,4,2.75,3140,10918,1.0,0,0,3,8,1900,1240,98034,47.7086,-122.243,3170,10918,7778,7748,52,30,0,543,446000.0,0.0029240092823326,0.0020579207234954,0.0021053098129598,0.0072350456274651,0.0030514658105877,0.0023679927541764,1.2780269058295963
2201500490,435000.0,3,1.0,950,10080,1.0,0,0,4,7,950,0,98006,47.572,-122.139,1060,10000,9130,8940,66,110,-80,490,760184.5,0.0006720567979959,0.0015317796407338,0.0008428553810992,0.0,0.0007771916253936,0.0016738578389189,0.5722295048110031
1722800860,400000.0,3,2.75,2220,5000,2.0,0,0,3,7,2220,0,98108,47.5515,-122.324,960,5000,2780,4040,27,-1260,0,185,345000.0,0.0070357810667765,0.0051802144816003,0.0092376830892143,0.0,0.0033024871856617,0.0053438043398103,1.1594202898550725
3343901234,341500.0,3,1.5,1130,7223,1.0,0,0,4,7,1130,0,98056,47.5089,-122.189,1320,7356,6093,6036,59,190,133,404,380000.0,0.0013871140784713,0.0018666108466551,0.0015645855371374,0.0,0.001711363061784,0.0023247060697392,0.8986842105263158
5104450440,252500.0,3,2.0,1810,10684,2.0,0,0,3,8,1810,0,98058,47.4619,-122.153,2140,9657,8874,7517,33,330,-1027,451,335000.0,0.0019530997095168,0.0012102715396672,0.0022184580613373,0.0,0.0023970097862964,0.0015520446021971,0.753731343283582
9382200121,187300.0,2,1.0,1310,7697,1.0,0,0,3,6,850,460,98146,47.4982,-122.348,1270,6410,6387,5140,70,-40,-1287,281,312000.0,0.0028656554475891,0.0030398762090686,0.0021946924590367,0.0065864833906071,0.0029375164801613,0.0027597691954648,0.6003205128205128
6414600070,210000.0,1,1.0,930,7129,1.0,0,0,3,6,930,0,98133,47.7234,-122.333,1300,8075,6199,6775,72,370,946,484,375000.0,0.0011910891165192,0.0020755549758584,0.0014070570720504,0.0,0.0017324532470838,0.0024814216041322,0.56
2787700060,420000.0,3,2.5,1810,7210,1.0,0,0,5,7,1210,600,98059,47.5067,-122.163,1770,7210,5400,5440,52,-40,0,465,435000.0,0.0016149035072849,0.0010754765248534,0.001143515980872,0.009573958831977,0.0016179410466158,0.0012309768407329,0.9655172413793104
6882200140,275000.0,3,1.5,1030,7184,1.0,0,0,4,7,1030,0,98056,47.5069,-122.189,1330,7262,6154,5932,52,300,78,404,380000.0,0.0012643606201995,0.0018565322334723,0.0014261266400456,0.0,0.0017243279334642,0.0022949993853244,0.7236842105263158
8568700015,446000.0,3,1.75,1460,9998,1.0,0,0,3,7,960,500,98028,47.7434,-122.242,1460,9998,8538,8538,62,0,0,282,442500.0,0.0024375136692761,0.0029790095731744,0.0019104819787817,0.0051824212271973,0.0024758855530382,0.0035065924850615,1.007909604519774
7955040080,665000.0,5,2.75,2330,8000,1.0,0,0,4,7,1550,780,98052,47.6651,-122.144,1750,8419,5670,6669,48,-580,419,571,615000.0,0.0017238598479747,0.0012602493718444,0.0012899381495462,0.0051996533564429,0.0013124452054126,0.0014671188671242,1.08130081300813
2473100280,358000.0,4,2.75,2580,11900,1.0,0,0,4,7,1620,960,98058,47.4475,-122.159,1570,9375,9320,7805,53,-1010,-2525,451,335000.0,0.0027839763815213,0.001348018656125,0.0019855812482687,0.0086603518267929,0.001758553908638,0.0015067223926269,1.0686567164179104
5631500400,180000.0,2,1.0,770,10000,1.0,0,0,3,6,770,0,98028,47.7379,-122.233,2720,8062,9230,5342,87,1950,-1938,282,442500.0,0.0012855380310565,0.0029796054942733,0.0015323657538144,0.0,0.0046126087015506,0.0028275803775321,0.4067796610169492
9284801100,317000.0,3,1.5,1060,5750,1.0,0,0,2,7,1060,0,98126,47.5532,-122.372,1060,5750,4690,4690,39,0,0,352,396587.5,0.001949091925427,0.0032027930583498,0.0024114859530943,0.0,0.0021323076799285,0.0032560654837239,0.7993191918555174
5049800005,447000.0,2,1.0,1320,8380,1.0,0,0,3,7,1320,0,98177,47.705,-122.367,1290,8025,7060,6735,67,-30,-355,254,557000.0,0.0022347125347057,0.0027675435178054,0.0028259957353155,0.0,0.0023230686115613,0.0026993771754793,0.8025134649910234
2645500021,339275.0,3,1.5,1590,7260,1.0,0,0,3,7,1080,510,98133,47.7753,-122.353,1590,7594,5670,6004,56,0,334,484,375000.0,0.0020363781669522,0.0021136946450739,0.0016340017610907,0.0042555321918494,0.0021189235868178,0.0023336118466601,0.9047333333333332
8562780180,336750.0,2,2.25,1170,1011,2.0,0,0,3,7,1170,0,98027,47.5321,-122.073,1240,750,-159,-490,11,70,-261,411,571000.0,0.0011314416016571,7.47014767174117e-05,0.0013462682479757,0.0,0.0012693226218882,6.403484588477502e-05,0.589754816112084
686530170,458000.0,3,2.25,2150,9900,1.0,0,0,3,8,1450,700,98052,47.6647,-122.149,2170,9500,7750,7330,43,20,-400,571,615000.0,0.0015906861258136,0.0015595585976575,0.0012067163334465,0.0046663555762949,0.0016274320547117,0.0016554969993681,0.7447154471544716
9424400200,451555.0,2,1.0,1320,4520,1.0,0,1,3,6,1320,0,98116,47.5655,-122.394,1420,4560,3200,3140,108,100,40,329,565500.0,0.0021628990712642,0.002759110711759,0.002825572285417,0.0,0.0025469527145673,0.0028130731405185,0.7985057471264367
6150700005,500000.0,4,2.5,1900,5001,1.0,0,0,3,8,1200,700,98133,47.7289,-122.335,1950,4680,3101,2730,12,50,-321,484,375000.0,0.0024334078724586,0.001456003707991,0.001815557512323,0.0058409265378325,0.0025986798706257,0.0014381489916209,1.3333333333333333
4070700300,898888.0,3,2.5,2080,3729,2.0,0,0,3,9,2080,0,98033,47.6731,-122.199,2080,4000,1649,1920,24,0,271,431,678000.0,0.0020282610879085,0.0008233538387961,0.0023448165462881,0.0,0.002186431092732,0.0009346630784951,1.3257935103244838
2856102336,652000.0,3,2.0,1700,4080,1.0,0,0,4,7,850,850,98117,47.6785,-122.393,1480,5100,2380,3620,79,-220,1020,548,545000.0,0.0018320979245563,0.0016059558921065,0.0011620785072896,0.0043268007126495,0.0017535960567785,0.0020049021823949,1.196330275229358
3179101050,672324.0,2,1.75,1600,5795,1.5,0,0,3,8,1600,0,98105,47.6709,-122.276,2310,6301,4195,3991,80,710,506,229,675000.0,0.0032488497041516,0.0049413897456143,0.0041258167827912,0.0,0.0049725005650568,0.0055710035498459,0.9960355555555556
2923501020,580000.0,4,2.25,2610,7700,1.0,0,0,3,8,1700,910,98027,47.5659,-122.089,2260,8266,5090,6006,43,-350,566,411,571000.0,0.0025239851113889,0.0005689429977488,0.0019561162577424,0.0055148172838009,0.0023134428431188,0.0007057493814447,1.0157618213660244
2592210150,822000.0,3,2.5,2290,9158,2.0,0,0,4,8,2290,0,98006,47.5476,-122.14,2210,9588,6868,7378,36,-80,430,490,760184.5,0.0016200105972745,0.0013916704315318,0.0020317250765445,0.0,0.001620371218981,0.0016048948959555,1.0813164435738956
2946001675,234000.0,2,1.0,940,5375,1.0,0,0,4,5,940,0,98198,47.4206,-122.324,1200,7500,4435,6300,68,260,2125,275,266750.0,0.001953770465226,0.0018520483827396,0.0023130433498773,0.0,0.0025430194117148,0.0028701696002351,0.8772258669165885
1395500020,279900.0,3,1.0,1400,10800,1.0,0,0,3,6,1400,0,98034,47.719,-122.202,1430,10000,9400,8570,58,30,-800,543,446000.0,0.0013036984061355,0.0020356790450403,0.0015512809148125,0.0,0.0013765287410537,0.0021688887655032,0.6275784753363228
4019500030,450000.0,3,2.5,2280,4557,2.0,0,0,3,8,2280,0,98028,47.7733,-122.266,2070,4610,2277,2540,10,-210,53,282,442500.0,0.0038065281958558,0.0013578062237403,0.0045373946996065,0.0,0.0035103308868418,0.001616862508115,1.0169491525423728
8562790730,760000.0,4,3.25,3140,3680,2.0,0,0,3,10,2310,830,98027,47.5319,-122.076,2620,2664,540,44,11,-520,-1016,411,571000.0,0.0030365184864986,0.0002719104197033,0.0026580167972853,0.0050299981819283,0.0026819558623767,0.0002274517725827,1.3309982486865148
8146300180,860000.0,5,2.25,1960,8592,1.0,0,0,4,8,1290,670,98004,47.6066,-122.192,1720,8592,6632,6872,62,-240,0,315,1150000.0,0.0021376843207399,0.0020846384564358,0.0016933356086163,0.0043206293931772,0.0020430465149427,0.0021311891797501,0.7478260869565218
1126049095,450000.0,3,2.5,2820,10208,1.0,0,1,4,8,1410,1410,98028,47.7609,-122.26,1540,10684,7388,9144,66,-1280,476,282,442500.0,0.0047080743475059,0.0030415812885542,0.0028060204063356,0.0146144278606965,0.0026115505148485,0.0037471928496096,1.0169491525423728
114101516,310000.0,3,1.0,1430,19901,1.5,0,0,4,7,1430,0,98028,47.7558,-122.229,1780,12697,18471,10917,93,350,-7204,282,442500.0,0.0023874277719622,0.0059297128941533,0.0028458221142269,0.0,0.0030185454002794,0.0044532111205067,0.7005649717514124
3575302759,365000.0,2,1.75,1270,7500,1.0,0,0,4,7,1270,0,98074,47.6186,-122.063,1280,7500,6230,6220,38,10,0,435,645000.0,0.0011009692864245,0.001181766570849,0.0011935091895508,0.0,0.0011361608945846,0.0013048112042572,0.5658914728682171
1515910290,397450.0,4,2.5,2650,9451,2.0,0,0,4,8,2650,0,98042,47.3693,-122.129,2510,8850,6801,6340,27,-140,-601,546,292000.0,0.0024474084253651,0.0009110542664832,0.0026271230128044,0.0,0.002348896252715,0.001100354848897,1.3611301369863014
3630030290,600000.0,4,2.5,2310,3866,2.0,0,0,3,8,2310,0,98029,47.5498,-121.996,1950,4023,1556,2073,15,-360,157,320,574500.0,0.003164210180264,0.0013902004175635,0.0033275713050993,0.0,0.0027548987751296,0.0017829506836638,1.0443864229765014
9126100861,557000.0,3,3.5,1710,2096,2.0,0,0,3,8,1290,420,98122,47.6055,-122.305,1630,1543,386,-87,12,-80,-553,289,574000.0,0.003307773848856,0.0020697125805148,0.0029849088561551,0.0049534143177261,0.0032949395388701,0.0015007172903445,0.970383275261324
5381000477,399500.0,4,2.5,2560,7492,2.0,0,0,3,8,2560,0,98188,47.4467,-122.287,1260,11541,4932,10281,6,-1300,4049,135,265000.0,0.0104992474172261,0.0054748192659269,0.0126994835874056,0.0,0.0056953271197013,0.008758569031503,1.5075471698113208
269000970,1300000.0,5,3.75,4450,7680,2.0,0,0,3,9,3460,990,98199,47.6418,-122.392,2550,6400,3230,3850,10,-1900,-1280,316,689900.0,0.0065127987472009,0.0044678385434846,0.006879958640711,0.0054890219560878,0.0040503192604593,0.0038343006954462,1.8843310624728224
2207200405,460000.0,5,2.0,1910,12264,1.0,0,0,4,7,1010,900,98007,47.601,-122.134,1700,9179,10354,7479,57,-210,-3085,139,560000.0,0.0062723720074874,0.0082463080221972,0.0038443970767356,0.0215362526920315,0.0057374282821464,0.0068824502392624,0.8214285714285714
1778500595,683000.0,5,1.5,1720,4000,1.5,0,0,3,7,1520,200,98112,47.6197,-122.287,2280,4000,2280,1720,95,560,0,268,917500.0,0.0025678847198915,0.0029885850992135,0.00282958103585,0.0015079544597753,0.0037285302885849,0.0030450554009767,0.7444141689373297
3211230300,381500.0,2,2.0,2160,35183,1.0,0,0,3,9,2160,0,98092,47.312,-122.115,2450,34992,33023,32542,35,290,-191,351,309780.0,0.0028027305862248,0.003084707904473,0.0029802681413474,0.0,0.0032769869910304,0.003299864429438,1.2315191426173413
7878400135,355000.0,3,2.25,2550,9674,1.0,0,0,3,7,1850,700,98178,47.4856,-122.247,2240,9674,7124,7434,61,-310,0,258,279500.0,0.0056909480449919,0.0045130067335889,0.0053924854985862,0.0066660318064946,0.0052603151492379,0.0046107394865464,1.2701252236135958
8562400025,816000.0,3,1.5,1180,8545,1.0,0,0,3,8,1180,0,98004,47.624,-122.2,1660,9000,7365,7340,68,480,455,315,1150000.0,0.0012869732135066,0.0020732350570582,0.001548942649742,0.0,0.001971777450468,0.0022323909005762,0.7095652173913043
7714000070,378000.0,4,2.5,2790,4650,2.0,0,0,3,8,2790,0,98038,47.3556,-122.026,2820,4650,1860,1830,16,30,0,586,342750.0,0.0022132985128855,0.0003121574659204,0.0023137935266857,0.0,0.0022698752936953,0.0003965219313295,1.1028446389496718
8857600680,285900.0,5,1.5,1690,7725,1.5,0,0,4,7,1690,0,98032,47.3859,-122.288,1690,7739,6035,6049,59,0,14,123,250000.0,0.0078712285637103,0.0060413155600045,0.0095620685753083,0.0,0.0082258857429337,0.0067713059022093,1.1436
2944510080,242550.0,4,2.5,2060,7720,2.0,0,0,3,8,2060,0,98023,47.2956,-122.374,1630,7720,5660,6090,25,-430,0,492,269000.0,0.0020949330079068,0.0014947668638067,0.0024439986190221,0.0,0.0016807727842671,0.001609206998633,0.9016728624535316
5127000470,292000.0,3,2.25,1780,9720,1.0,0,0,3,8,1280,500,98059,47.4762,-122.156,1710,9790,7940,8080,39,-70,70,465,435000.0,0.0015881371508105,0.0014498795869036,0.0012096697979473,0.0079782990266475,0.0015630955874085,0.0016714650860992,0.671264367816092
9542600070,516000.0,3,3.0,2330,7304,1.0,0,0,3,9,1300,1030,98005,47.5982,-122.172,2330,9518,4974,7188,49,0,2214,168,765475.0,0.0052202006080525,0.0021815774979719,0.0035821257436355,0.0123456790123456,0.0054010074153745,0.0030844653517774,0.6740912505307162
88000591,212000.0,3,1.0,1000,9450,1.0,0,0,3,6,1000,0,98055,47.4562,-122.193,1300,13500,8450,12200,58,300,4050,260,297225.0,0.0021506208842492,0.0036036599456819,0.0024234786612703,0.0,0.0027984974221533,0.0068332875249984,0.7132643620153083
8078520310,278500.0,3,2.0,1570,5250,1.0,0,0,3,7,1570,0,98092,47.3163,-122.188,1570,5250,3680,3680,22,0,0,351,309780.0,0.0020371699168393,0.000460299476977,0.0021662134175535,0.0,0.0020999467656807,0.0004950928284907,0.8990251145974563
1138000830,310000.0,3,1.0,1990,7173,1.0,0,0,3,7,1990,0,98034,47.7116,-122.213,1320,7245,5183,5925,48,-670,72,543,446000.0,0.0018531141630069,0.0013520301657476,0.0022050350146263,0.0,0.0012706419148188,0.001571359910607,0.695067264573991
4139490210,1285000.0,4,3.5,4080,14450,2.0,0,2,3,12,3210,870,98006,47.5519,-122.106,4080,12114,10370,8034,22,0,-2336,490,760184.5,0.0028863070903407,0.002195854742917,0.0028479639719249,0.0030371792633967,0.0029914545581189,0.0020277113860664,1.6903791119129632
4024100090,250000.0,3,1.75,1360,16000,1.0,0,0,3,7,1360,0,98155,47.7583,-122.306,1360,12939,14640,11579,42,0,-3061,442,377225.0,0.0017266771621552,0.0035132027256305,0.002088035250948,0.0,0.0017898905402968,0.0029786425870612,0.6627344423089668
6127011000,537500.0,4,2.5,2550,4630,2.0,0,0,3,7,2550,0,98075,47.5928,-122.004,2550,5151,2080,2601,15,0,521,358,739999.5,0.0023588025423266,0.0006800366074133,0.0025118772391415,0.0,0.0023880496377188,0.0009556486982695,0.7263518421296231
8807300570,399950.0,3,1.0,1040,9600,1.0,0,0,3,7,1040,0,98053,47.6738,-122.063,1370,10889,8560,9519,42,330,1289,400,635000.0,0.0009923039197913,0.0006810599222059,0.0010223883384813,0.0,0.0013843767525754,0.0009372273700344,0.6298425196850393
5632500110,351000.0,3,1.0,1160,10518,1.0,0,0,3,7,1160,0,98028,47.7343,-122.22,1670,9380,9358,7710,60,510,-1138,282,442500.0,0.0019366546961372,0.0031339490588767,0.0023084990576945,0.0,0.0028320060777902,0.0032898417193316,0.7932203389830509
2126049154,435000.0,4,2.75,2160,8148,1.0,0,0,3,7,1410,750,98125,47.7261,-122.306,2060,8100,5988,6040,42,-100,-48,402,425000.0,0.0030671013620201,0.0026345885783406,0.0024636868287108,0.0056846174252472,0.0030877243471561,0.0027518933705869,1.0235294117647058
1425069071,875000.0,4,2.5,3230,256132,2.0,0,0,3,9,3230,0,98053,47.6544,-121.998,3080,217800,252902,214720,14,-150,-38332,400,635000.0,0.0030818669816595,0.0181709624994218,0.0031753022435525,0.0,0.0031123214583449,0.0187462688211506,1.3779527559055118
259600280,400000.0,4,2.0,1420,9301,1.0,0,0,4,7,1420,0,98008,47.6325,-122.121,1530,8075,7881,6545,57,110,-1226,283,545000.0,0.0023519084411981,0.003225782957281,0.0029290187374691,0.0,0.0026749187034511,0.0030051163268435,0.7339449541284404
7527000020,792000.0,3,2.5,2250,19270,2.0,0,0,3,8,2250,0,98074,47.6569,-122.088,2940,19541,17020,16601,21,690,271,435,645000.0,0.0019505361373662,0.0030363522427014,0.0021144847846373,0.0,0.0026096195547491,0.0033996420989854,1.227906976744186
2600110710,602000.0,3,2.25,1580,11580,1.0,0,0,4,8,1580,0,98006,47.5503,-122.155,2630,10009,10000,7379,41,1050,-1571,490,760184.5,0.0011177365692986,0.0017597230396525,0.0014018015811966,0.0,0.0019283150705521,0.0016753643109739,0.7919130158533882
1931300110,700000.0,3,1.0,1570,4000,2.0,0,0,5,8,1570,0,98103,47.6575,-122.346,1640,4000,2430,2360,112,70,0,599,550000.0,0.0015874460318904,0.0019192301583988,0.001865434450178,0.0,0.0017967876941954,0.0019236540192827,1.2727272727272727
7849200315,276000.0,2,1.0,1140,7200,1.0,0,0,3,6,1140,0,98065,47.5265,-121.823,1110,7200,6060,6090,97,-30,0,305,500000.0,0.0014475271411338,0.0013693325796932,0.0015166028097062,0.0,0.0014395860217494,0.0020852599059258,0.552
3423059177,420000.0,5,2.75,2540,27007,1.0,0,0,3,8,1520,1020,98058,47.4326,-122.155,1800,26572,24467,24772,40,-740,-435,451,335000.0,0.0027408139570015,0.0030593226761319,0.0018630145045484,0.0092016238159675,0.0020161764557634,0.0042705735911342,1.2537313432835822
7893800250,348000.0,3,2.5,2370,7500,1.0,0,3,3,8,1620,750,98198,47.4091,-122.331,1960,8062,5130,6102,41,-410,562,275,266750.0,0.0049259957474315,0.0025842535573111,0.0039863087519162,0.0100361300682456,0.0041535983724675,0.0030852409756127,1.3045923149015932
1657530350,280000.0,3,2.5,1720,1916,2.0,0,0,3,7,1720,0,98059,47.4895,-122.166,1760,1916,196,156,15,40,0,465,435000.0,0.0015346044378619,0.0002857993095172,0.0016254937909917,0.0,0.001608800136748,0.0003271222783417,0.6436781609195402
2767601100,513000.0,4,2.0,2090,4000,1.0,0,0,3,7,1480,610,98107,47.6751,-122.379,1510,5000,1910,3490,69,-580,1000,264,529975.0,0.0050061079307288,0.0047388985378128,0.0042527513577196,0.0087795048934945,0.0037608966376089,0.0054975140241582,0.9679701872729846
1522059120,409124.0,5,3.25,3320,11340,2.0,0,0,4,8,2480,840,98042,47.3904,-122.154,2330,8339,8020,6009,21,-990,-3001,546,292000.0,0.0030661871593253,0.0010931494425901,0.0024585905931151,0.0113406237343053,0.0021804495094924,0.0010368202355878,1.4011095890410958
5651500140,272000.0,3,2.0,1380,7476,1.0,0,0,3,7,1380,0,98001,47.3336,-122.272,1600,7227,6096,5627,31,220,-249,358,260000.0,0.0020200364192073,0.0013953048253918,0.0022324100646104,0.0,0.0024391879943166,0.0018023697908158,1.0461538461538462
301401620,298900.0,3,2.5,1852,4000,2.0,0,0,3,7,1852,0,98002,47.3451,-122.209,2475,4000,2148,1525,6,623,0,197,235000.0,0.0057766507278517,0.0027039414001819,0.006180234595298,0.0,0.0084976498418922,0.0026759880249535,1.2719148936170213
1828000760,529950.0,3,2.0,1540,8400,1.0,0,0,3,7,1180,360,98052,47.6554,-122.129,1550,8760,6860,7210,52,10,360,571,615000.0,0.0011393751784897,0.0013232618404366,0.0009820174299771,0.0023998400106659,0.0011624514676512,0.0015265424962594,0.8617073170731707
1563100557,445000.0,3,1.5,1310,1266,2.0,0,0,3,8,1120,190,98116,47.5663,-122.408,1310,1378,-44,68,18,0,112,329,565500.0,0.0021465134722395,0.000772795168382,0.002397455272475,0.0013274645427233,0.0023496535606219,0.0008500909622005,0.7869142351900973
6021503706,329900.0,2,2.5,980,1021,3.0,0,0,3,8,980,0,98117,47.6844,-122.387,980,1023,41,43,12,0,2,548,545000.0,0.0010561505682736,0.0004018825896668,0.0013398081613457,0.0,0.0011611649565155,0.0004021597907039,0.6053211009174312
4137020910,297300.0,3,1.75,1980,9220,2.0,0,0,3,8,1980,0,98092,47.2602,-122.219,2080,8305,7240,6225,33,100,-915,351,309780.0,0.0025691697040394,0.0008083735576625,0.0027319124629018,0.0,0.0027820950780992,0.0007831897029744,0.9597133449544838
2325039067,690000.0,3,2.0,1760,6428,1.0,0,0,4,7,980,780,98199,47.6388,-122.397,1760,6004,4668,4244,78,0,-424,316,689900.0,0.0025758484932749,0.0037394877809269,0.0019486588057505,0.0043246839654025,0.0027955144699641,0.0035970533399155,1.0001449485432672
8122100130,415000.0,3,1.75,1270,4800,1.0,0,0,3,7,1270,0,98126,47.5362,-122.376,1220,4800,3530,3580,68,-50,0,352,396587.5,0.0023352327785776,0.0026736359443616,0.0028892331702167,0.0,0.0024541654429366,0.0027181068385869,1.0464273331862453
255520150,539000.0,3,2.5,2830,9972,2.0,0,0,3,9,2830,0,98019,47.7382,-121.975,3557,9159,7142,5602,14,727,-813,190,401250.0,0.0068590097819658,0.0013174281930954,0.0073148162507818,0.0,0.008899018531074,0.0013022638404455,1.3433021806853582
1442880510,499431.0,4,2.75,2620,6019,2.0,0,0,3,8,2620,0,98045,47.484,-121.771,2790,6716,3399,3926,7,170,697,218,404750.0,0.0058052579683812,0.0005457524429199,0.0061797554043376,0.0,0.0066782358925258,0.0009494124061737,1.2339246448424954
1796370150,240000.0,3,2.25,1500,15334,2.0,0,0,4,7,1500,0,98042,47.3719,-122.091,1530,8102,13834,6572,28,30,-7232,546,292000.0,0.0013853255237915,0.0014781616889486,0.0014870507619648,0.0,0.001431797317392,0.001007353105736,0.821917808219178
1121000357,1085000.0,4,3.0,3410,6541,2.0,0,2,3,9,2680,730,98126,47.5416,-122.38,2300,6345,3131,4045,13,-1110,-196,352,396587.5,0.0062701919487793,0.0036433859816811,0.0060969644851818,0.007000383582662,0.0046267053432411,0.003592997477257,2.7358401361616287
6662410070,420000.0,4,2.25,2030,12000,2.0,0,0,3,7,2030,0,98011,47.7699,-122.168,2190,9900,9970,7710,43,160,-2100,194,470000.0,0.0046378374426553,0.0054570730715726,0.0053402923744307,0.0,0.005016779868739,0.0053620551728396,0.8936170212765957
7714000310,374950.0,4,2.5,2790,4650,2.0,0,0,3,8,2790,0,98038,47.3557,-122.026,2850,4650,1860,1800,16,60,0,586,342750.0,0.0022132985128855,0.0003121574659204,0.0023137935266857,0.0,0.0022940229032026,0.0003965219313295,1.0939460247994164
859000018,342000.0,3,2.5,1740,2226,2.0,0,0,3,8,1320,420,98106,47.525,-122.366,1740,1789,486,49,12,0,-437,330,315000.0,0.0035357876576626,0.0012187957356384,0.0033568909086747,0.0042471432905248,0.0038678528081945,0.001063282231597,1.0857142857142856
1525069134,1295000.0,4,3.5,3790,90169,2.0,0,0,3,11,3790,0,98053,47.6587,-122.022,3410,46951,86379,43541,22,-380,-43218,400,635000.0,0.0036161844769317,0.006396926263061,0.0037258190411963,0.0,0.003445784471739,0.004041120603406,2.0393700787401574
9301300215,1010000.0,3,3.25,2420,1923,2.0,0,2,3,10,1840,580,98109,47.637,-122.341,1840,2890,-497,1050,14,-580,967,109,736000.0,0.0108049702863317,0.0048720794126142,0.0103097982305248,0.0127472527472527,0.0087539844902231,0.0073532405145741,1.372282608695652
2771602420,472000.0,3,2.5,1180,1262,3.0,0,0,3,8,1180,0,98119,47.6381,-122.375,1180,2632,82,1452,10,0,1370,184,744975.0,0.0031975460189197,0.0018971737823211,0.0040334571855356,0.0,0.0034378277590024,0.0038375234559873,0.6335783079969126
2719100400,499950.0,3,1.75,1340,6250,1.0,0,0,4,7,1090,250,98136,47.5427,-122.386,1550,1755,4910,205,79,210,-4495,263,489950.0,0.002950528012401,0.0039724155464454,0.0030651556480413,0.0025368863271974,0.003524489517486,0.0011598405698352,1.0204102459434636
2190600243,210000.0,3,1.5,1400,9600,1.0,0,0,4,7,1400,0,98003,47.2878,-122.297,2210,15000,8200,12790,56,810,5400,276,269500.0,0.0026262622472926,0.0032736148687587,0.0030494844193128,0.0,0.0042582298480717,0.0055618301239101,0.7792207792207793
847100046,600000.0,4,2.75,3110,11225,2.0,0,0,3,8,3110,0,98059,47.4865,-122.143,2610,8535,8115,5925,8,-500,-2690,465,435000.0,0.0027747789545061,0.0016743722595672,0.0029391195872001,0.0,0.0023857774755183,0.0014571965791477,1.3793103448275863
2877101340,426000.0,2,1.0,640,2500,1.0,0,0,4,6,640,0,98117,47.6776,-122.361,1460,4200,1860,2740,102,820,1700,548,545000.0,0.0006897309833623,0.0009840416005554,0.0008749767584298,0.0,0.001729898812768,0.0016510959149135,0.781651376146789
3352400330,216000.0,2,1.0,1810,10360,1.0,0,0,3,6,1010,800,98178,47.5039,-122.266,1810,10360,8550,8550,74,0,0,258,279500.0,0.0040394572397786,0.0048330318131053,0.0029440055965254,0.0076183220645652,0.0042505225089824,0.0049376949638847,0.7728085867620751
3814900380,356250.0,3,2.5,2060,5115,2.0,0,0,3,9,2060,0,98092,47.3261,-122.163,2648,4500,3055,1852,6,588,-615,351,309780.0,0.0026729745405662,0.0004484632047119,0.0028422927644332,0.0,0.0035418210417341,0.0004243652815635,1.1500096842920782
4232902335,1200000.0,5,4.0,2710,2800,3.0,0,0,3,10,2380,330,98119,47.6346,-122.364,1530,3600,90,2070,46,-1180,800,184,744975.0,0.0073435167044681,0.0042092603728202,0.0081352780521819,0.0043148535564853,0.0044575224332828,0.0052488922650282,1.610792308466727
5100402782,511000.0,2,1.0,1250,5413,1.0,0,0,4,7,1250,0,98115,47.6945,-122.315,1250,5413,4163,4163,97,0,0,576,570000.0,0.0011835921928365,0.001724135185194,0.0015409555156961,0.0,0.0012828789034156,0.0017779947123297,0.8964912280701754
713500020,1387000.0,4,4.5,4490,24767,2.0,0,2,3,11,3800,690,98006,47.5544,-122.147,3370,32700,20277,29330,22,-1120,7933,490,760184.5,0.0031763526557916,0.00376364944068,0.0033714215243971,0.0024087973468319,0.0024708828090344,0.005473515133265,1.8245570647651983
9485940290,464950.0,4,2.25,2350,36116,1.0,0,0,4,9,2350,0,98042,47.3533,-122.082,2580,36116,33766,33536,37,230,0,546,292000.0,0.0021703433206068,0.0034814978190993,0.0023297128604115,0.0,0.0024144033195238,0.0044904424545497,1.5922945205479453
6204050080,555000.0,3,2.5,3160,4270,2.0,0,0,3,8,2650,510,98011,47.7453,-122.194,2720,12523,1110,9803,14,-440,8253,194,470000.0,0.0072194907974338,0.0019418085013012,0.006971317631646,0.0088580112896222,0.0062308864123151,0.0067827289827748,1.180851063829787
9547205610,719000.0,4,2.75,2210,3400,1.5,0,0,5,7,1470,740,98115,47.6826,-122.311,1500,3400,1190,1900,94,-710,0,576,570000.0,0.0020925909969349,0.0010829594734268,0.0018121636864586,0.0030213700688382,0.0015394546840987,0.0011167895846889,1.2614035087719295
4016800120,374000.0,3,2.5,1850,17808,1.0,0,0,4,8,1210,640,98032,47.3631,-122.271,2260,16754,15958,14494,38,410,-1054,123,250000.0,0.0086164336348308,0.0139266987045386,0.006846214778771,0.016857188010325,0.0110002969106688,0.0146590591918355,1.496
3835502815,1260000.0,3,2.5,3110,9930,1.0,0,1,3,8,1640,1470,98039,47.6112,-122.226,3650,14399,6820,10749,66,540,4469,49,1905000.0,0.0164702767112405,0.0115189331588673,0.0100413286392162,0.0576470588235294,0.0235940530058177,0.0168126982051198,0.6614173228346457
1708400555,346500.0,2,1.75,1610,6300,1.0,0,0,3,7,1010,600,98108,47.554,-122.304,1370,5225,4690,3855,79,-240,-1075,185,345000.0,0.0051025259087883,0.0065270702468164,0.0042027296937416,0.0079776625448743,0.0047129244212047,0.0055842755351018,1.0043478260869565
1133000144,614905.0,3,2.5,2410,7225,2.0,0,0,3,8,2410,0,98125,47.7211,-122.31,1940,8347,4815,6407,29,-470,1122,402,425000.0,0.0034220899455873,0.0023361441431653,0.00421098245191,0.0,0.0029078569094577,0.0028358091313937,1.446835294117647
1862400522,449000.0,3,2.5,1810,1658,3.0,0,0,3,8,1810,0,98117,47.6955,-122.376,1470,1585,-152,115,22,-340,-73,548,545000.0,0.0019506454373217,0.0006526163894883,0.0024745436449344,0.0,0.0017417474347733,0.0006230921488423,0.8238532110091743
1102000196,477000.0,4,2.75,1720,6270,2.0,0,0,3,8,1720,0,98118,47.5458,-122.268,2130,8700,4550,6570,42,410,2430,498,370000.0,0.002035967978485,0.0021755408144641,0.0025893280543156,0.0,0.0026520674297482,0.0031430272482399,1.2891891891891891
6806300980,490000.0,4,2.5,3630,8387,2.0,0,0,3,10,3630,0,98042,47.3623,-122.127,3370,8869,4757,5499,23,-260,482,546,292000.0,0.0033524877675756,0.0008084871582895,0.0035986628439548,0.0,0.0031536973592229,0.0011027171926404,1.678082191780822
2320069364,370000.0,3,2.5,2490,18525,2.0,0,3,3,8,2490,0,98022,47.2119,-122.001,1850,9516,16035,7666,25,-640,-9009,233,280000.0,0.0058164795582278,0.0010710258062583,0.0061850446118077,0.0,0.0044072803506765,0.0007932113908356,1.3214285714285714
952001735,750000.0,4,1.75,2100,6613,2.0,0,0,3,8,2100,0,98116,47.567,-122.385,1630,5750,4513,4120,111,-470,-863,329,565500.0,0.0034409757951931,0.0040367254727571,0.0044952286358907,0.0,0.0029236147357357,0.0035471865258731,1.326259946949602
424069250,785000.0,4,2.75,2440,69415,1.0,0,0,4,8,1910,530,98075,47.5944,-122.042,2770,24361,66975,21591,31,330,-45054,358,739999.5,0.0022570502757948,0.0101954084457021,0.0018814453046119,0.0080449301760777,0.0025940774496004,0.004519619091156,1.0608115275753565
1024069215,1206690.0,5,4.25,4150,12015,2.0,0,0,3,10,4150,0,98075,47.5816,-122.021,3230,27520,7865,24290,6,-920,15505,358,739999.5,0.0038388355100609,0.0017647170276613,0.0040879570754656,0.0,0.0030248628744438,0.0051056983452491,1.630663263961665
3083000048,427000.0,5,2.75,2220,4000,1.0,0,0,3,7,1230,990,98144,47.5754,-122.305,1580,4000,1780,2420,47,-640,0,340,452500.0,0.00341546868846,0.0028724138401516,0.0024443512632129,0.0067446502660389,0.0026386678401501,0.0029981231748925,0.943646408839779
3278603000,459000.0,3,3.0,2440,2076,2.0,0,0,3,8,1930,510,98126,47.5476,-122.37,2440,2310,-364,-130,14,0,234,352,396587.5,0.0044865889604168,0.0011563475459364,0.0043907244240302,0.0048906789413118,0.0049083308858732,0.0013080889160699,1.1573738456204494
9187200045,625000.0,4,1.5,2120,5000,2.0,0,0,4,8,2120,0,98122,47.6024,-122.296,1830,5000,2880,3170,120,-290,0,289,574000.0,0.0041008658243127,0.0049372914611519,0.004905431608565,0.0,0.0036992265988542,0.0048629853867289,1.088850174216028
8128700005,249000.0,4,1.0,1200,7552,1.0,0,0,3,6,1060,140,98126,47.5317,-122.37,1580,7680,6352,6100,101,380,128,352,396587.5,0.0022065191608607,0.0042065205524623,0.0024114859530943,0.0013425393172228,0.0031783454097048,0.004348970941739,0.6278563999117471
4215270070,969990.0,4,2.5,4150,8436,2.0,0,0,3,10,4150,0,98075,47.5802,-122.039,4070,8438,4286,4368,6,-80,2,358,739999.5,0.0038388355100609,0.0012390472613692,0.0040879570754656,0.0,0.00381151451981,0.0015654753865265,1.3107981829717452
6197800101,235000.0,3,1.0,1330,45738,2.0,0,0,2,6,1330,0,98058,47.436,-122.185,1490,24000,44408,22510,53,160,-21738,451,335000.0,0.0014351506152803,0.0051811493524242,0.0016301376914798,0.0,0.0016689460661597,0.0038572093251249,0.7014925373134329
4233600150,1150000.0,5,4.25,4010,8252,2.0,0,0,3,10,4010,0,98075,47.5974,-122.013,3370,8252,4242,4882,5,-640,0,358,739999.5,0.0037093326253842,0.0012120220484612,0.0039500500897872,0.0,0.0031559714820048,0.0015309673962571,1.5540551040912864
2591730230,250000.0,4,2.5,2040,5770,2.0,0,0,3,7,2040,0,98038,47.3522,-122.059,1570,6753,3730,5183,26,-470,983,586,342750.0,0.0016183257943679,0.0003873437802927,0.0016918060195121,0.0,0.0012637248975537,0.0005758521725308,0.7293946024799417
3296900280,425000.0,3,2.5,1800,14036,2.0,0,0,3,8,1800,0,98019,47.7334,-121.97,2450,14025,12236,11575,27,650,-11,190,401250.0,0.0043626210627344,0.0018543343480031,0.0046525333043842,0.0,0.006129489851316,0.0019941314949502,1.059190031152648
2436700610,550000.0,4,2.0,1720,4000,1.0,0,0,3,7,1420,300,98105,47.6651,-122.285,1350,1281,2280,-69,70,-370,-2719,229,675000.0,0.0034925134319629,0.0034107953377838,0.0036616623947272,0.0028658769583492,0.0029060068237345,0.0011325909454614,0.8148148148148148
2652500210,608000.0,2,1.0,1390,3600,1.0,0,0,4,7,1010,380,98119,47.6422,-122.36,1590,3600,2210,2010,107,200,0,184,744975.0,0.0037666008188969,0.0054119061936259,0.003452365896094,0.0049686192468619,0.004632327234588,0.0052488922650282,0.8161347696231417
9353300140,284950.0,3,1.0,990,10723,1.0,0,0,5,7,990,0,98059,47.4887,-122.133,1460,10723,9733,9263,60,470,0,465,435000.0,0.000883289763653,0.0015994916471571,0.0009356039843498,0.0,0.0013345728407114,0.0018307579283189,0.6550574712643679
4022902715,525000.0,5,3.25,2480,10277,2.0,0,0,5,8,1640,840,98155,47.7726,-122.286,2270,10277,7797,8007,27,-210,0,442,377225.0,0.0031486465898126,0.0022565740257065,0.0025179248614373,0.0061624238867287,0.0029875378871131,0.002365832743429,1.3917423288488302
7574910490,864500.0,4,2.5,3520,35991,2.0,0,0,4,10,3520,0,98077,47.7437,-122.035,3210,35991,32471,32781,28,-310,0,196,652475.0,0.0062897015072054,0.0033345915299095,0.0067146740426343,0.0,0.0058892598979928,0.004024337677164,1.3249549791179738
9194102188,675000.0,4,3.5,3190,6875,2.0,0,2,3,8,2120,1070,98034,47.7082,-122.221,2550,6875,3685,4325,21,-640,0,543,446000.0,0.0029705699396946,0.0012958605032085,0.0023490825281446,0.0062431442107965,0.0024546491536273,0.0014911110262834,1.5134529147982063
8961960160,480000.0,4,2.5,3230,16171,2.0,0,3,3,9,2520,710,98001,47.3183,-122.253,2640,8517,12941,5877,19,-590,-7654,358,260000.0,0.0047280562565504,0.003018121232131,0.004076574900593,0.0109247576550238,0.0040246601906225,0.0021240879352952,1.8461538461538465
5706200280,382500.0,3,1.75,1040,9000,1.0,0,0,4,7,1040,0,98027,47.5253,-122.043,1750,10878,7960,9128,53,710,1878,411,571000.0,0.0010057258681396,0.000664998309057,0.0011966828870895,0.0,0.0017913827325035,0.0009287614047127,0.669877408056042
6632300477,324950.0,3,1.0,1040,7288,1.0,0,0,3,7,1040,0,98125,47.7287,-122.311,1160,7287,6248,6127,61,120,-1,402,425000.0,0.0014767525076393,0.0023565146734102,0.0018171874481271,0.0,0.001738718564418,0.0024756848137613,0.7645882352941177
6052400175,446000.0,2,1.0,2550,21675,1.0,0,1,4,7,1610,940,98198,47.4013,-122.319,2030,10591,19125,8561,62,-520,-11084,275,266750.0,0.0053001220067301,0.0074684927806292,0.0039617019077686,0.0125786163522012,0.0043019411714842,0.004053062164812,1.6719775070290537
5418200295,549500.0,3,1.75,1620,8438,1.0,0,0,4,8,1620,0,98125,47.703,-122.281,2040,9450,6818,7410,59,420,1012,402,425000.0,0.0023003260215151,0.0027283576858172,0.0028306189095826,0.0,0.003057746440873,0.0032105422656847,1.2929411764705885
2783100050,334000.0,3,1.75,1400,7405,1.0,0,0,3,7,1400,0,98133,47.7569,-122.334,1820,7440,6005,5620,59,420,35,484,375000.0,0.0017930373797064,0.0021559103094728,0.0021181504310436,0.0,0.0024254345459173,0.0022862881405255,0.8906666666666667
2770601696,439990.0,3,2.5,1930,1348,2.0,0,0,3,8,1300,630,98199,47.6513,-122.384,1630,6000,-582,4370,15,-300,4652,316,689900.0,0.0028246520409208,0.0007841987443512,0.0025849555586486,0.0034930139720558,0.0025890276057053,0.0035946569019808,0.63775909552109
7560000050,730000.0,3,3.5,2440,3502,2.0,0,0,3,7,1970,470,98005,47.589,-122.165,2440,3417,1062,977,20,0,-85,168,765475.0,0.0054666478470593,0.0010459863633485,0.0054282982422784,0.0056334651803907,0.0056559905980746,0.0011073353758167,0.9536562265260132
3982700250,799900.0,4,2.5,3030,7800,2.0,0,0,3,9,1580,1450,98033,47.689,-122.196,2840,7435,4770,4595,29,-190,-365,431,678000.0,0.0029546303347898,0.0017222204190427,0.0017811587226611,0.0104733975701717,0.0029853193766148,0.0017373049971527,1.179793510324484
5451220150,980000.0,4,2.25,3010,9800,2.0,0,0,4,9,3010,0,98040,47.5336,-122.223,2510,9800,6790,7290,47,-500,0,282,993750.0,0.0034355749794264,0.0025357994068816,0.0043137979910026,0.0,0.003070539216046,0.0027147100163381,0.9861635220125786
629810560,820000.0,4,2.5,3720,8633,2.0,0,0,3,10,3720,0,98074,47.6085,-122.013,3515,9660,4913,6145,21,-205,1027,435,645000.0,0.0032248864137789,0.0013602921074852,0.0034959481772671,0.0,0.0031200043316134,0.0016805968310833,1.2713178294573644
4218400100,1865000.0,6,2.75,4460,6952,2.5,0,2,4,10,3460,1000,98105,47.6626,-122.269,2750,4769,2492,2019,90,-1710,-2183,229,675000.0,0.0090561685503226,0.0059279622970683,0.008922078792786,0.0095529231944975,0.0059196435298296,0.0042164919741652,2.762962962962963
3275300050,272000.0,3,3.0,2430,10500,1.0,0,0,4,8,2150,280,98003,47.2579,-122.312,1670,9800,8070,8130,37,-760,-700,276,269500.0,0.0045584409006578,0.0035805162627048,0.0046831367868018,0.0037846532311476,0.0032177573965067,0.0036337290142879,1.0092764378478665
9510300220,556000.0,3,2.5,2750,35440,2.0,0,0,3,9,2750,0,98045,47.4745,-121.723,2710,35440,32690,32730,26,-40,0,218,404750.0,0.0060933051194841,0.0032134019898792,0.0064863844892856,0.0,0.0064867452576147,0.0050100023339486,1.3736874613959231
301400320,255900.0,3,2.5,1489,3266,2.0,0,0,3,7,1489,0,98002,47.3452,-122.217,1537,3273,1777,1736,6,48,7,197,235000.0,0.0046444022320579,0.0022077681532485,0.0049688819181419,0.0,0.0052771263866619,0.0021896272014182,1.088936170212766
2408800130,424900.0,4,2.75,2950,49658,1.0,0,0,4,8,2950,0,98010,47.3596,-121.922,1720,54672,46708,52952,60,-1230,5014,99,359999.0,0.0140203128193185,0.0092865957757565,0.0149986780826096,0.0,0.0087077144274677,0.0118874656728555,1.1802810563362676
2695600410,428950.0,2,1.0,1760,4441,1.0,0,0,3,8,1310,450,98126,47.5311,-122.381,1350,5748,2681,4398,70,-410,1307,352,396587.5,0.0032362281025957,0.0024736702560229,0.0029802326401448,0.0043153049482163,0.0027156748753806,0.0032549329392078,1.0816024206511805
1483300430,554000.0,2,1.0,820,3700,1.0,0,0,5,7,820,0,98040,47.588,-122.251,1750,9000,2880,7250,52,930,5300,282,993750.0,0.0009359373698105,0.0009573936536185,0.0011751874925655,0.0,0.0021408141944544,0.0024931010354125,0.5574842767295598
8682261250,545000.0,2,1.75,1660,5581,1.0,0,0,3,8,1660,0,98053,47.713,-122.033,1670,4871,3921,3201,15,10,-710,400,635000.0,0.0015838697181284,0.000395937023524,0.0016318890787298,0.0,0.0016875249465701,0.0004192519532957,0.8582677165354331
7202300540,825000.0,4,2.75,3990,6637,2.0,0,0,3,9,3990,0,98053,47.6835,-122.045,3500,7074,2647,3574,17,-490,437,400,635000.0,0.0038070121538147,0.0004708536149667,0.0039224321832119,0.0,0.0035367289299374,0.0006088664170836,1.2992125984251968
6744700423,432000.0,3,1.75,1470,6250,1.0,0,3,4,7,1070,400,98155,47.7394,-122.288,2630,7050,4780,4420,81,1160,800,442,377225.0,0.0018663348738002,0.0013723448146994,0.0016427924400841,0.0029344875651089,0.0034613324418976,0.0016229561974481,1.1452051163098946
2028700535,855000.0,4,3.0,2550,5300,2.0,0,0,3,8,1720,830,98117,47.6786,-122.367,1590,4505,2750,2915,112,-960,-795,548,545000.0,0.0027481468868345,0.0020861681931776,0.0023515000382802,0.0042249936370577,0.0018839308988364,0.0017709969277822,1.5688073394495412
2025049192,527500.0,3,2.5,1380,1389,3.0,0,0,3,8,1380,0,98102,47.6427,-122.327,1380,1249,9,-131,12,0,-140,104,710000.0,0.0061687281244831,0.0037046322572385,0.007571850274891,0.0,0.0067891668511548,0.0036354216390541,0.7429577464788732
2600040130,578000.0,3,2.25,1790,9580,2.0,0,0,3,8,1790,0,98006,47.5541,-122.162,2060,9995,7790,7935,36,270,415,490,760184.5,0.0012662964930661,0.0014557985077609,0.0015881169812291,0.0,0.0015103912719914,0.0016730209099995,0.7603417328293329
4038400040,520000.0,3,2.0,1670,8800,1.0,0,0,4,7,1150,520,98008,47.6096,-122.132,2020,8250,7130,6230,59,350,-550,283,545000.0,0.002765976828733,0.0030520255912345,0.0023720926394996,0.0043711804709106,0.0035315920137067,0.0030702426868679,0.9541284403669724
6851700381,935000.0,4,2.0,2580,4500,2.0,0,0,4,9,1850,730,98102,47.6245,-122.316,2590,4100,1920,1510,115,10,-400,104,710000.0,0.0115328395370771,0.0120020483495849,0.0101506688467742,0.0176094560366662,0.0127419870612254,0.0119337299600656,1.3169014084507042
3879901285,1230000.0,3,2.5,2660,1967,3.0,0,3,3,9,1870,790,98119,47.6264,-122.363,1640,1369,-693,-271,13,-1020,-598,184,744975.0,0.0072080274663783,0.0029570054119061,0.0063920041838572,0.0103294979079497,0.0047779979023423,0.0019960370863399,1.6510621161783952
5647900930,195000.0,3,1.0,1070,22489,1.0,0,0,3,7,1070,0,98001,47.3278,-122.262,1880,20250,21419,18370,53,810,-2239,358,260000.0,0.001566260122139,0.0041972993871371,0.0017309266442994,0.0,0.0028660458933221,0.0050502266865949,0.75
6130500060,370000.0,3,2.5,1650,1793,3.0,0,0,3,8,1650,0,98133,47.7107,-122.332,1650,1863,143,213,13,0,70,484,375000.0,0.0021132226260825,0.0005220185259803,0.0024963915794442,0.0,0.0021988829674525,0.0005724939255106,0.9866666666666668
1402200070,365000.0,4,2.25,1990,21312,1.0,0,0,4,8,1990,0,98058,47.439,-122.144,2400,19210,19322,16810,52,410,-2102,451,335000.0,0.0021473306198555,0.0024141994621292,0.0024390782000338,0.0,0.0026882352743512,0.0030873746306521,1.0895522388059702
1822059440,511000.0,4,3.5,3100,7600,2.0,0,0,3,10,3100,0,98031,47.3892,-122.215,3350,7638,4500,4288,15,250,38,271,288400.0,0.0059200299438933,0.0023103232233386,0.0066942209438419,0.0,0.0064675934953385,0.0033203007832571,1.7718446601941749
976000790,670000.0,3,2.5,1800,4763,2.0,0,0,3,7,1240,560,98119,47.646,-122.362,1790,4763,2963,2973,35,-10,0,184,744975.0,0.0048776125712334,0.0071602525556223,0.0042385482288679,0.0073221757322175,0.0052150099056054,0.0069445760717581,0.8993590388939227
2887700805,458950.0,2,1.0,1530,4370,1.0,0,0,3,7,1130,400,98115,47.6888,-122.308,1580,4275,2840,2695,74,50,-95,576,570000.0,0.0014487168440319,0.0013919214408457,0.0013930237861893,0.0016331730101828,0.0016215589339173,0.0014041986689838,0.8051754385964912
2425059074,740000.0,5,3.0,3655,51836,1.0,0,0,5,8,2174,1481,98008,47.6434,-122.115,2530,8606,48181,6076,65,-1125,-43230,283,545000.0,0.00605367982576,0.0179778180167313,0.0044842864332802,0.012449458225805,0.0044232315815238,0.0032027283106892,1.3577981651376148
8731902680,218000.0,3,2.25,1610,7084,1.0,0,0,4,8,1280,330,98023,47.3146,-122.384,2170,8505,5474,6335,52,560,1421,492,269000.0,0.0016373020110339,0.0013716228579284,0.0015186010836642,0.0023496909800347,0.0022375932158648,0.0017728375030276,0.8104089219330854
9492800020,425000.0,3,1.75,1960,43332,1.0,0,0,4,7,1400,560,98077,47.739,-122.048,2010,44431,41372,42421,38,50,1099,196,652475.0,0.0035022201574212,0.0040147403565903,0.0026706089942295,0.0158102766798418,0.0036876674127618,0.0049680572180288,0.651365952718495
7852130550,530000.0,4,2.5,3020,6788,2.0,0,0,3,7,3020,0,98065,47.5346,-121.881,2640,5325,3768,2685,18,-380,-1463,305,500000.0,0.0038346771633547,0.0012909763265219,0.0040176670923797,0.0,0.0034238802679445,0.0015422234720909,1.06
2944500710,305000.0,4,2.5,2430,9103,2.0,0,0,3,8,2430,0,98023,47.2939,-122.368,2260,8090,6673,5830,30,-170,-1013,492,269000.0,0.0024712073831134,0.001762546989797,0.0028829692447688,0.0,0.0023303966211311,0.001686332204526,1.133828996282528
2205500400,542000.0,4,1.75,1900,8250,1.0,0,0,4,7,950,950,98006,47.5765,-122.147,1480,8360,6350,6880,65,-420,110,490,760184.5,0.0013441135959919,0.001253688694053,0.0008428553810992,0.0033164601152033,0.0010851354769647,0.0013993451533362,0.7129848082932498
7518504291,535000.0,2,1.0,1520,3360,1.0,0,0,4,7,830,690,98117,47.6815,-122.382,1470,3774,1840,2304,93,-50,414,548,545000.0,0.0016381110854856,0.0013225519111465,0.0011347354835887,0.0035123441079155,0.0017417474347733,0.0014836276149722,0.981651376146789
1422300030,415000.0,3,2.25,1510,36224,2.0,0,0,3,8,1510,0,98045,47.4616,-121.711,1730,36224,34714,34494,29,220,0,218,404750.0,0.0033457784474258,0.0032844885350278,0.003561614755935,0.0,0.0041409849799533,0.0051208330853542,1.02532427424336
323059208,320000.0,3,2.0,1880,10758,1.0,0,0,5,6,940,940,98059,47.5091,-122.144,2060,21000,8878,18940,68,180,10242,465,435000.0,0.0016773583390583,0.0016047124069865,0.0008883512578675,0.0149992021700973,0.0018830274327846,0.0035853694390279,0.735632183908046
1982201596,540000.0,3,1.75,1630,1404,2.0,0,0,3,8,1020,610,98107,47.6646,-122.367,1420,1670,-226,250,6,-210,266,264,529975.0,0.003904285132578,0.0016633533867723,0.0029309502600499,0.0087795048934945,0.0035367372353673,0.0018361696840688,1.0189159866031416
7199360100,379500.0,3,1.0,1110,7128,1.0,0,0,3,7,1110,0,98052,47.6968,-122.124,1510,7107,6018,5597,40,400,-21,571,615000.0,0.000821237953327,0.0011228821903134,0.0009237621587073,0.0,0.0011324527200989,0.0012384860183693,0.6170731707317073
2114700374,357500.0,3,3.0,1730,1442,2.0,0,0,3,8,1440,290,98106,47.5344,-122.348,1370,1524,-288,154,12,-360,82,330,315000.0,0.0035154670389404,0.0007895343444702,0.0036620628094633,0.002932551319648,0.0030453783604749,0.0009057809507847,1.1349206349206349
4204400098,385000.0,5,1.75,2190,8250,1.0,0,2,3,7,1190,1000,98055,47.4887,-122.223,2570,8250,6060,5680,57,380,0,260,297225.0,0.0047098597365059,0.0031460523335318,0.0028839396069117,0.019101466992665,0.0055324141345646,0.0041758979319434,1.2953149970561022
326069131,599000.0,4,2.5,2790,230868,2.0,0,0,3,8,2790,0,98077,47.7647,-122.019,1590,217800,228078,216210,31,-1200,-13068,196,652475.0,0.0049853031832679,0.0213900830020607,0.0053221422099289,0.0,0.002917110042931,0.0243533312796624,0.9180428368903024
9208900037,6885000.0,6,7.75,9890,31374,2.0,0,4,3,13,8860,1030,98039,47.6305,-122.24,4540,42730,21484,38190,19,-5350,11356,49,1905000.0,0.052376539123527,0.0363942607176539,0.0542476656972294,0.040392156862745,0.0293471234647705,0.0498928116053038,3.614173228346457
7524950730,653675.0,4,2.25,2280,7229,2.0,0,0,4,8,2280,0,98027,47.5609,-122.081,2320,7735,4949,5415,36,40,506,411,571000.0,0.0022048605570754,0.0005341414195748,0.0026234970986193,0.0,0.0023748616796618,0.0006604127105583,1.1447898423817864
381000240,650500.0,4,1.75,2340,5940,1.0,0,0,3,8,1290,1050,98115,47.6789,-122.281,1930,5940,3600,4010,67,-410,0,576,570000.0,0.0022156845849899,0.0018919939035751,0.0015902660921984,0.0042870791517299,0.0019807650268737,0.0019510970979565,1.1412280701754387
323089172,410000.0,4,2.5,1900,15123,2.0,0,0,3,8,1900,0,98045,47.5015,-121.772,1900,16477,13223,14577,25,0,1354,218,404750.0,0.0042099199007345,0.0013712268141349,0.0044815020107791,0.0,0.0045479025791394,0.0023292835343248,1.012970969734404
475000004,536000.0,2,1.5,1130,746,2.0,0,0,3,8,1030,100,98107,47.6684,-122.363,1520,1519,-384,-1,11,390,773,264,529975.0,0.002706651656327,0.000883804577302,0.002959685066521,0.0014392630972941,0.003785803237858,0.0016701447605392,1.0113684607764517
8925100390,1042500.0,3,1.75,1900,9375,1.0,0,1,4,8,1330,570,98115,47.6821,-122.273,2760,9375,7475,6615,79,860,0,576,570000.0,0.0017990601331115,0.0029861014892285,0.0016395766687007,0.0023272715395105,0.0028325966187417,0.0030793830460173,1.8289473684210529
8687800065,305000.0,2,1.0,2160,12960,1.0,0,0,3,7,1360,800,98168,47.4702,-122.261,2070,12960,10800,10890,52,-90,0,264,237000.0,0.0055445747875863,0.0043247731079201,0.0041548284605749,0.0128534704370179,0.0053099796835559,0.0050239354083168,1.2869198312236287
2558650200,419950.0,3,2.25,2280,8500,1.0,0,0,4,7,1680,600,98034,47.7211,-122.166,1890,7700,6220,5810,43,-390,-800,543,446000.0,0.0021231659757065,0.0016021548039669,0.001861537097775,0.0035008285294186,0.0018193281962179,0.0016700443494374,0.941591928251121
5001700040,255000.0,3,1.75,1590,7810,1.0,0,0,4,7,1590,0,98002,47.2932,-122.22,1470,7810,6220,6340,61,-120,0,197,235000.0,0.0049594355600887,0.0052794455838553,0.0053059249495269,0.0,0.0050470889970026,0.0052248666187218,1.0851063829787233
1775950030,375000.0,4,1.75,1940,15909,1.0,0,0,3,8,970,970,98072,47.7578,-122.094,1940,15120,13969,13180,46,0,-789,272,517500.0,0.0030100993487944,0.0018992430604924,0.00171241643143,0.0124285677677267,0.0030268988329276,0.0023172797342852,0.7246376811594203
251300260,255000.0,4,2.5,2070,7800,2.0,0,0,3,8,2070,0,98003,47.3487,-122.315,1950,7815,5730,5865,31,-120,15,276,269500.0,0.0038831163227826,0.0026598120808664,0.0045088805342696,0.0,0.0037572616306515,0.0028977134945571,0.9461966604823748
5706200170,425000.0,3,1.75,1680,14630,1.5,0,0,3,8,1680,0,98027,47.5272,-122.044,1920,14630,12950,12710,35,240,0,411,571000.0,0.0016246340946871,0.0010809916957227,0.0019331031252984,0.0,0.0019654027693753,0.0012491063937256,0.7443082311733801
3336001360,254000.0,2,1.0,910,6000,1.0,0,0,3,6,910,0,98118,47.5253,-122.266,1460,5800,5090,4340,77,550,-200,498,370000.0,0.0010771691048961,0.0020818572387217,0.0013699351915274,0.0,0.0018178490363532,0.0020953514988266,0.6864864864864865
3530490031,202200.0,2,1.75,1330,2159,1.0,0,0,4,8,1330,0,98198,47.3822,-122.32,1220,3679,829,2459,41,-110,1520,275,266750.0,0.0027643773603729,0.0007439204573646,0.0032727102716349,0.0,0.0025854030685767,0.0014079138612353,0.7580131208997188
7796450200,256883.0,3,2.5,1690,5025,2.0,0,0,3,8,1690,0,98023,47.2779,-122.347,2550,5001,3335,2451,17,860,-24,492,269000.0,0.0017186586327002,0.0009729538200296,0.0020050279932754,0.0,0.002629429815878,0.0010424409585704,0.9549553903345724
4037700285,415000.0,3,1.0,1300,7975,1.0,0,0,4,7,1300,0,98008,47.611,-122.122,1570,9075,6675,7505,62,270,1100,283,545000.0,0.0021531556151814,0.0027658981920563,0.0026814960272605,0.0,0.002744851218574,0.0033772669555547,0.7614678899082569
5425700150,787500.0,4,1.75,1580,9382,1.0,0,0,3,7,1080,500,98039,47.6353,-122.232,2010,9382,7802,7372,57,430,0,49,1905000.0,0.0083675360783794,0.0108832458103215,0.0066125822746058,0.0196078431372549,0.0129928894634777,0.0109547006431303,0.4133858267716535
5104500020,250000.0,2,1.5,1088,1360,2.0,0,0,3,7,1088,0,98034,47.7094,-122.213,1098,1469,272,371,37,10,109,543,446000.0,0.0010131599041967,0.0002563447686347,0.0012055668823685,0.0,0.0010569430473265,0.0003186097596524,0.5605381165919282
7399000230,350000.0,4,2.5,2260,7500,1.0,0,0,3,8,1460,800,98055,47.4645,-122.196,2260,7500,5240,5240,55,0,0,260,297225.0,0.0048604031984033,0.002860047575938,0.0035382788454547,0.015281173594132,0.0048650801338973,0.0037962708472213,1.1775590882328202
7227801955,162000.0,4,2.0,1440,7641,1.0,0,0,4,5,1440,0,98056,47.508,-122.183,1440,7750,6201,6310,77,0,109,404,380000.0,0.0017676497991139,0.0019746329058967,0.001993808118122,0.0,0.0018669415219462,0.0024492213214354,0.4263157894736842
6072000380,505000.0,4,2.75,2200,9778,1.0,0,0,4,8,1100,1100,98006,47.5472,-122.176,2140,11321,7578,9181,58,-60,1543,490,760184.5,0.001556342058517,0.0014858870364182,0.0009759378096939,0.0038401117123407,0.0015690472437192,0.0018949744594401,0.6643124136311646
1226059161,562000.0,4,2.75,2560,83200,1.0,0,0,3,8,1860,700,98072,47.7511,-122.111,1990,38332,80640,36342,40,-570,-44868,272,517500.0,0.0039720898623267,0.0099325553229602,0.0032836026417112,0.0089690695231017,0.0031049116894464,0.0058747332522898,1.0859903381642513
2622029072,520000.0,4,3.5,2734,210201,2.0,0,0,5,8,2734,0,98070,47.3652,-122.504,2270,187308,207467,185038,46,-464,-22893,116,466250.0,0.0123992054349699,0.0187577535992495,0.013926171932702,0.0,0.0110370982642096,0.0200532324740574,1.1152815013404829
3260000120,599380.0,3,1.75,1270,7350,1.0,0,0,4,7,1270,0,98005,47.6046,-122.168,1880,7350,6080,5470,53,610,0,168,765475.0,0.0028453453958054,0.002195316896234,0.0034994613033977,0.0,0.0043578943952378,0.0023818890875776,0.783017080897482
2787311480,253000.0,3,1.75,1570,7416,1.0,0,0,4,7,1570,0,98031,47.4117,-122.174,1900,7416,5846,5516,49,330,0,271,288400.0,0.0029982087135202,0.002254389082142,0.0033902989941393,0.0,0.0036681873555651,0.0032237955758883,0.8772538141470181
1189000180,525000.0,2,1.0,1510,3360,1.0,0,0,3,7,880,630,98122,47.6135,-122.297,1330,3360,1850,2030,96,-180,0,289,574000.0,0.0029208997144868,0.003317859861894,0.0020362168941213,0.0074301214765892,0.002688508948894,0.0032679261798818,0.9146341463414634
3401700185,665000.0,4,2.0,2970,52567,2.0,0,0,3,8,2970,0,98072,47.7333,-122.128,3280,46676,49597,43396,96,310,-5891,272,517500.0,0.00460824487934,0.0062755364863227,0.0052431719601518,0.0,0.0051176433876302,0.0071535283649139,1.285024154589372
7749500970,267500.0,3,2.25,1860,12000,1.0,0,0,4,7,1860,0,98092,47.2942,-122.19,1815,9604,10140,7789,44,-45,-2396,351,309780.0,0.0024134624492491,0.0010521130902332,0.0025663420106047,0.0,0.0024276454647837,0.0009056898142524,0.8635160436438764
1330250010,289950.0,3,2.0,1670,7757,1.0,0,0,3,8,1670,0,98030,47.3802,-122.207,2290,7859,6087,5569,28,620,102,253,283000.0,0.0033504534146537,0.0025977601058795,0.0036472438193413,0.0,0.0047026449811072,0.0036220612519639,1.0245583038869257
3904900610,475000.0,3,2.5,1630,7586,2.0,0,0,3,8,1630,0,98029,47.5689,-122.023,2090,7330,5956,5240,34,460,-256,320,574500.0,0.0022327543696235,0.0027278997329635,0.0023480265053298,0.0,0.0029526863794979,0.0032485778054327,0.8268059181897301
5649600225,457500.0,3,1.0,960,4600,1.5,0,0,4,6,960,0,98118,47.5553,-122.286,1380,5175,3640,3795,93,420,575,498,370000.0,0.0011363542205497,0.0015960905496866,0.0014452063558971,0.0,0.0017182408699777,0.001869559311453,1.2364864864864864
8024200820,575700.0,3,1.75,1730,6130,1.0,0,0,3,7,1480,250,98115,47.6978,-122.316,1730,6131,4400,4401,79,0,1,576,570000.0,0.0016380915948857,0.0019525122270902,0.0018244913305842,0.0010207331313642,0.0017755044023272,0.002013834395214,1.01
193600200,440000.0,3,1.75,1170,8740,1.0,0,0,4,7,1170,0,98052,47.6849,-122.117,1870,8448,7570,6578,52,700,-292,571,615000.0,0.0008656291940474,0.00137682243874,0.0009736952483671,0.0,0.0014024414480695,0.0014721724895433,0.7154471544715447
621069074,365000.0,3,2.5,1720,99916,2.0,0,0,4,7,1720,0,98042,47.3391,-122.093,1340,73180,98196,71840,30,-380,-26736,546,292000.0,0.0015885066006143,0.0096316684043951,0.0017051515403863,0.0,0.0012539924217681,0.0090987534285067,1.25
7934000090,340000.0,2,1.0,690,5200,1.0,0,0,3,6,690,0,98136,47.556,-122.395,1380,5700,4510,4320,102,690,500,263,489950.0,0.0015193017377288,0.0033050497346426,0.0019403278872922,0.0,0.0031379326026649,0.0037670035601488,0.693948362077763
1250202430,799000.0,3,1.5,2210,6300,1.5,0,0,5,8,2210,0,98144,47.5892,-122.29,2700,6300,4090,3600,104,490,0,340,452500.0,0.0034000836943678,0.0045240517982387,0.0043918831639841,0.0,0.0045091159293705,0.0047220440004557,1.7657458563535913
5093300325,1610000.0,4,3.5,4390,11600,2.0,0,3,3,11,3060,1330,98040,47.5862,-122.246,3240,12000,7210,8760,30,-1150,400,282,993750.0,0.0050106890895954,0.003001558481615,0.0043854557649395,0.0074565780473857,0.0039635645657327,0.0033241347138834,1.620125786163522
5559200020,248500.0,3,2.0,1240,12285,1.0,0,0,3,7,620,620,98023,47.3219,-122.341,1560,11564,11045,10004,81,320,-721,492,269000.0,0.0012610276358274,0.0023786542644904,0.0007355723998998,0.0044145709321864,0.0016085923579489,0.0024104753539108,0.9237918215613384
7518502210,645500.0,2,1.0,1890,5202,1.5,0,0,4,7,1890,0,98117,47.6786,-122.379,1670,5100,3312,3430,111,-220,-102,548,545000.0,0.002036861810242,0.0020475937624358,0.0025839157397381,0.0,0.0019787198748785,0.0020049021823949,1.1844036697247706
1898200100,355000.0,3,2.5,2400,9701,1.0,0,0,3,9,2400,0,98023,47.3081,-122.392,2400,8258,7301,5858,30,0,-1443,492,269000.0,0.0024406986499885,0.0018783333349468,0.0028473770318704,0.0,0.0024747574737675,0.0017213512169315,1.3197026022304832
7165700200,275000.0,3,3.0,1390,1080,2.0,0,0,3,7,1140,250,98118,47.5323,-122.281,1450,1081,-310,-369,14,60,1,498,370000.0,0.001645346215171,0.0003747343029699,0.0017161825476278,0.0013847193450831,0.0018053980155563,0.0003905301672813,0.7432432432432432
5350201180,1665000.0,4,3.75,3450,8395,2.0,0,4,4,10,2640,810,98122,47.6134,-122.282,3180,5183,4945,2003,27,-270,-3212,289,574000.0,0.0066735788178673,0.008289712363274,0.006108650682364,0.0095530133270432,0.0064281642537467,0.0050409706518831,2.9006968641114983
6056100114,477000.0,3,2.5,2100,5060,2.0,0,0,3,7,2100,0,98108,47.563,-122.298,1520,2468,2960,948,14,-580,-2592,185,345000.0,0.0066554685766805,0.0052423770553796,0.0087383488681757,0.0,0.0052289380439643,0.0026377018221304,1.382608695652174
8078350100,626100.0,4,2.5,2280,7219,2.0,0,0,4,8,2280,0,98029,47.5719,-122.021,2240,7471,4939,5231,33,-40,252,320,574500.0,0.0031231165415593,0.0025959277843743,0.0032843560933448,0.0,0.0031646016698924,0.0033110675012808,1.0898172323759792
2009003136,325000.0,1,1.0,1220,12426,1.0,0,4,4,6,1220,0,98198,47.4047,-122.331,2770,22270,11206,19500,74,1550,9844,275,266750.0,0.0025357446463571,0.0042815912937531,0.003002034986011,0.0,0.005870136475375,0.0085224902662981,1.218369259606373
1026069155,539000.0,3,2.0,1800,43995,2.0,0,0,3,8,1800,0,98077,47.7585,-122.022,2290,51400,42195,49110,32,490,7405,196,652475.0,0.0032163246343664,0.0040761677741205,0.003433640135438,0.0,0.0042013723259824,0.0057472967299111,0.8260852906241618
5631500947,610000.0,4,3.0,2600,29539,1.0,0,0,3,8,2600,0,98028,47.746,-122.231,1810,11600,26939,9790,26,-790,-17939,282,442500.0,0.004340777767204,0.008801456669534,0.0051742220258671,0.0,0.0030694197609583,0.0040684609748663,1.3785310734463276
2423400040,315000.0,3,1.75,1970,8200,1.0,0,0,3,7,1270,700,98168,47.4731,-122.327,1890,8348,6230,6458,56,-80,148,264,237000.0,0.0050568575609004,0.0027363533553198,0.0038798765771545,0.0112467866323907,0.0048482423197685,0.0032360966657892,1.3291139240506329
8682261010,473000.0,2,1.75,1510,4555,1.0,0,0,3,8,1510,0,98053,47.7136,-122.031,1640,4500,3045,2860,15,130,-55,400,635000.0,0.0014407489604662,0.0003231487443383,0.001484429222218,0.0,0.0016572101271706,0.0003873196037427,0.7448818897637796
6793300220,739000.0,3,2.75,2950,6667,2.0,0,0,3,9,2950,0,98029,47.5577,-122.026,3340,6667,3717,3327,17,390,0,320,574500.0,0.0040408744726316,0.0023974304666053,0.0042494958225295,0.0,0.0047186471327861,0.0029547432781473,1.286335944299391
3971700330,415000.0,4,2.0,1780,12161,1.0,0,0,5,7,1160,620,98155,47.7746,-122.323,1780,8170,10381,6390,70,0,-3991,442,377225.0,0.0022599156975267,0.0026702536466495,0.0017809712434556,0.0045484557259188,0.002342650854212,0.0018807875366172,1.100139174232885
8651442440,164000.0,4,1.0,1530,4875,2.0,0,0,3,7,1530,0,98042,47.3638,-122.091,1470,4875,3345,3405,43,-60,0,546,292000.0,0.0014130320342674,0.000469938583124,0.0015167917772041,0.0,0.0013756484029845,0.0006061276710026,0.5616438356164384
3581000210,383001.0,3,1.0,1180,7210,1.0,0,0,4,7,1180,0,98034,47.7267,-122.241,1700,7210,6030,5510,57,520,0,543,446000.0,0.0010988315137428,0.0013590042513648,0.0013075081996276,0.0,0.0016364327690848,0.0015637687999278,0.8587466367713005
9141100070,575000.0,5,2.5,1970,12375,1.0,0,0,3,8,1570,400,98133,47.7412,-122.354,1970,8941,10405,6971,61,0,-3434,484,375000.0,0.002523059741444,0.0036028885995579,0.002375354411956,0.0033376723073328,0.0026253329975039,0.0027475406269407,1.5333333333333334
5101408599,465000.0,4,1.75,1470,5350,1.0,0,0,3,7,980,490,98125,47.7048,-122.315,1970,6138,3880,4168,65,500,788,402,425000.0,0.0020873328713748,0.001729878362067,0.0017123497107352,0.0037139500511615,0.0029528237688823,0.0020853236430447,1.0941176470588236
5379802181,193000.0,2,1.0,680,8640,1.0,0,0,4,5,680,0,98188,47.4559,-122.289,1320,13140,7960,11820,69,640,4500,135,265000.0,0.0027888625952006,0.0063137264358795,0.0033733003279046,0.0,0.0059665331730204,0.0099720645588727,0.7283018867924528
8078100260,340000.0,4,2.5,2360,7475,2.0,0,0,3,8,2360,0,98031,47.4052,-122.17,2280,7570,5115,5290,28,-80,95,271,288400.0,0.0045068615056736,0.0022723244861126,0.0050962456217635,0.0,0.0044018248266781,0.0032907406296486,1.1789181692094313
1109000175,370000.0,4,2.0,1950,3757,1.0,0,0,4,6,1160,790,98118,47.5372,-122.269,1720,3757,1807,2037,112,-230,0,498,370000.0,0.0023082195104917,0.0013035896076462,0.0017462910133756,0.0043757131304627,0.0021415755770736,0.0013572819967399,1.0
3996900575,259950.0,2,1.0,770,6542,1.0,0,0,3,6,770,0,98155,47.747,-122.301,1120,8149,5772,7029,72,350,1607,442,377225.0,0.0009776039815143,0.0014364607644421,0.0011821964288455,0.0,0.0014740275037739,0.0018759531990078,0.6891112731128637
3432500760,370000.0,3,1.0,1440,8287,1.5,0,0,4,7,1440,0,98155,47.7438,-122.315,1330,8285,6847,6955,92,-110,-2,442,377225.0,0.0018282464069879,0.0018196194367062,0.002210860853945,0.0,0.0017504076607315,0.0019072612901926,0.9808469746172708
4083306553,560000.0,3,2.5,1390,1411,3.0,0,0,3,8,1390,0,98103,47.6485,-122.334,1350,1266,21,-84,12,-40,-145,599,550000.0,0.0014054458498902,0.0006770084383751,0.0016515629845525,0.0,0.0014790630409536,0.0006088364971029,1.018181818181818
642500080,365000.0,4,2.5,2905,4874,2.0,0,0,3,9,2905,0,98031,47.4084,-122.169,2900,5271,1969,2371,17,-5,397,271,288400.0,0.0055476409635517,0.0014816467619148,0.0062731328522131,0.0,0.0055988122795467,0.0022913466127976,1.265603328710125
241900020,378800.0,5,2.5,2740,5400,2.0,0,0,3,8,2740,0,98031,47.4036,-122.205,2900,5476,2660,2576,15,160,76,271,288400.0,0.0052325425955702,0.0016415454481616,0.0059168275439119,0.0,0.0055988122795467,0.0023804617817643,1.3134535367545075
7331900290,230000.0,4,1.5,1520,8800,1.0,0,0,4,7,1520,0,98002,47.3136,-122.208,1370,8800,7280,7430,60,-150,0,197,235000.0,0.0047410956297703,0.0059486710804003,0.0050723307693591,0.0,0.0047037496094514,0.0058871736548978,0.9787234042553192
9808700650,1208000.0,3,2.25,1590,8520,2.0,0,0,4,8,1590,0,98004,47.6477,-122.216,2470,12005,6930,9535,40,880,3485,315,1150000.0,0.0017341418724369,0.0020671694190914,0.0020871345873643,0.0,0.002933909820877,0.0029777614179353,1.0504347826086955
7201800300,397500.0,3,1.75,1300,8480,1.0,0,0,3,7,1300,0,98052,47.6991,-122.13,1740,7280,7180,5540,51,440,-1200,571,615000.0,0.0009618102156082,0.0013358643341551,0.0010818836092968,0.0,0.0013049455185246,0.001268633490042,0.6463414634146342
4178500440,279900.0,3,2.0,1410,6600,1.0,0,0,4,7,1410,0,98042,47.3596,-122.089,1750,7150,5190,5400,30,340,550,546,292000.0,0.001302205992364,0.0006362245433064,0.0013978277162469,0.0,0.0016376766702196,0.0008889872508038,0.9585616438356164
8024201503,475000.0,2,1.75,1710,8645,1.0,0,0,4,7,1510,200,98115,47.7005,-122.313,1280,5366,6935,4086,97,-430,-3279,576,570000.0,0.0016191541198003,0.0027535837199339,0.0018614742629609,0.0008165865050914,0.0013136679970976,0.001762556738659,0.8333333333333334
222069029,535000.0,2,1.75,1780,224769,1.0,0,0,4,8,1780,0,98038,47.4158,-122.002,2060,71560,222989,69500,44,280,-153209,586,342750.0,0.0014120685852818,0.015088886334941,0.0014761836836919,0.0,0.0016581358528412,0.0061021740657943,1.5609044493070752
7588700177,310000.0,1,0.75,520,2885,1.0,0,0,4,6,520,0,98117,47.6886,-122.378,980,4241,2365,3261,73,460,1356,548,545000.0,0.0005604064239819,0.001135584007041,0.0007109186162242,0.0,0.0011611649565155,0.0016672137559876,0.5688073394495413
3297700100,577000.0,3,1.75,1740,5500,1.0,0,0,5,7,970,770,98116,47.577,-122.395,1740,7250,3760,5510,67,0,1750,329,565500.0,0.0028510942303028,0.0033573249811226,0.0020763675127685,0.0053797247257737,0.003120913889681,0.0044725395326227,1.0203359858532273
6383900090,838300.0,6,2.5,3760,12978,1.0,0,0,3,9,2360,1400,98117,47.6976,-122.381,2300,7362,9218,5062,53,-1460,-5616,548,545000.0,0.004052169527254,0.0051083567568035,0.00322647679671,0.0071264952914227,0.0027251830612099,0.0028941352679984,1.538165137614679
7899800586,372000.0,4,1.0,2300,7680,1.0,0,0,3,7,1270,1030,98106,47.524,-122.359,1840,5120,5380,3280,61,-460,-2560,330,315000.0,0.0046737423061057,0.0042050095461382,0.0032297359500128,0.0104156133077156,0.00409014319947,0.0030430436141848,1.180952380952381
2649500155,750000.0,5,3.25,2750,7500,2.0,0,1,3,7,2150,600,98033,47.6636,-122.203,2750,7500,4750,4750,83,0,0,431,678000.0,0.0026815951883406,0.0016559811721564,0.0024237286415959,0.004333819684209,0.0028907141851024,0.0017524932721783,1.106194690265487
2141310490,625000.0,3,2.25,1920,8412,1.0,0,2,3,8,1460,460,98006,47.5578,-122.132,2490,8700,6492,6210,43,570,288,490,760184.5,0.0013582621601603,0.0012783065811362,0.0012953356383209,0.0016058648978879,0.0018256671200284,0.0014562563198595,0.8221688287514413
625049286,640000.0,3,1.0,1530,4944,1.0,0,0,3,7,1530,0,98103,47.6857,-122.341,1500,4944,3414,3444,70,-30,0,599,550000.0,0.0015470015470015,0.0023721684757809,0.0018179074578168,0.0,0.0016434033788373,0.0023776363678334,1.1636363636363636
1777600230,610000.0,4,3.0,2450,10117,1.0,0,0,5,8,1580,870,98006,47.5694,-122.132,2530,10125,7667,7595,53,80,8,490,760184.5,0.0017331991106212,0.0015374022445738,0.0014018015811966,0.0030371792633967,0.0018549951058923,0.0016947810619054,0.8024367768614067
7923500060,713000.0,5,2.75,2580,9242,2.0,0,2,4,8,1720,860,98007,47.5943,-122.133,2240,9316,6662,7076,53,-340,74,139,560000.0,0.0084726281567107,0.0062143165966362,0.0065468940316686,0.020579085905719,0.0075599055011812,0.0069851733771618,1.2732142857142856
8562000010,244500.0,3,1.75,1210,8864,1.0,0,0,3,7,1210,0,98042,47.3639,-122.08,1510,8062,7654,6552,35,300,-802,546,292000.0,0.0011174959225252,0.0008544688411921,0.0011995542813182,0.0,0.0014130810125895,0.0010023797504867,0.8373287671232876
2934800025,353750.0,4,2.0,1710,7490,2.0,0,0,3,7,1320,390,98166,47.4544,-122.357,1880,7704,5780,5824,64,170,214,250,392500.0,0.0032941122078642,0.0021929638360061,0.0030808010082621,0.0043023563674874,0.003978583370368,0.0024214559097951,0.9012738853503184
5315100476,760250.0,5,2.75,2540,8250,1.0,0,0,4,7,1440,1100,98040,47.5875,-122.24,2540,11000,5710,8460,67,0,2750,282,993750.0,0.0028991230723399,0.0021347290925279,0.0020637438893833,0.0061670946256573,0.003107238887951,0.0030471234877264,0.7650314465408805
8944360390,485000.0,3,2.5,1760,3097,2.0,0,0,3,8,1760,0,98029,47.5764,-121.996,1760,3285,1337,1525,28,0,188,320,574500.0,0.0024108268040107,0.0011136706397295,0.0025352924229328,0.0,0.0024864727406298,0.0014558769564593,0.8442123585726719
1823039205,585000.0,3,2.5,2270,100545,2.0,0,0,3,8,2270,0,98070,47.4815,-122.47,1277,100545,98275,99268,22,-993,0,116,466250.0,0.0102948779580767,0.0089723566283535,0.0115626957890393,0.0,0.0062089755433461,0.0107643680948176,1.2546916890080428
4055700167,760000.0,4,3.0,2840,13554,1.0,0,2,4,9,1990,850,98034,47.7153,-122.257,2840,16940,10714,14100,46,0,3386,543,446000.0,0.0026446453381607,0.0025547772015256,0.0022050350146263,0.004959507083343,0.002733805331883,0.0036740975687624,1.704035874439462
6163900981,220000.0,3,1.0,1180,5002,1.5,0,0,3,7,1180,0,98155,47.7529,-122.324,1470,8410,3822,6940,74,290,3408,442,377225.0,0.0014981463612818,0.0010983150021002,0.0018116776442049,0.0,0.0019346610987032,0.0019360371092963,0.5832063092318908
3145600045,302000.0,6,2.0,2650,4621,1.5,0,0,3,8,2650,0,98118,47.5543,-122.275,1640,4879,1971,3239,109,-1010,258,498,370000.0,0.0031368111296426,0.0016033770500221,0.003989371711591,0.0,0.0020419674106981,0.0017626241315129,0.8162162162162162
7851990240,771150.0,4,3.5,3950,12320,2.0,0,0,3,10,3950,0,98065,47.5414,-121.869,3920,11086,8370,7166,19,-30,-1234,305,500000.0,0.0050155545679639,0.0023430801919195,0.0052548957002979,0.0,0.0050839434281601,0.0032107210162629,1.5423
6145601599,250000.0,2,1.5,982,846,2.0,0,0,3,8,806,176,98133,47.7034,-122.345,1010,3844,-136,2834,14,28,2998,484,375000.0,0.0012576876477654,0.0002463065660788,0.0012194494624436,0.0014685758152264,0.0013459829073497,0.0011812488726048,0.6666666666666666
7852190320,555000.0,4,2.5,2870,6776,2.0,0,0,3,8,2870,0,98065,47.539,-121.878,2770,6658,3906,3888,16,-100,-118,305,500000.0,0.003644213065837,0.0012886941055557,0.0038181140911025,0.0,0.0035924804326539,0.0019282861741186,1.11
2113700360,315000.0,6,4.0,3120,4240,2.0,0,2,4,7,2090,1030,98106,47.5305,-122.353,1460,4240,1120,2780,27,-1660,0,330,315000.0,0.006340033041326,0.0023215156869304,0.0053150772720683,0.0104156133077156,0.0032454397126229,0.0025200204929968,1.0
46100204,1505000.0,5,3.0,3300,33474,1.0,0,3,3,9,1870,1430,98040,47.5673,-122.21,3836,20953,30174,17117,63,536,-12521,282,993750.0,0.0037665772199692,0.0086615662597916,0.0026800007452408,0.0080172230133545,0.0046926647142441,0.0058042162216665,1.5144654088050316
8658303065,307000.0,3,1.0,1370,7500,1.0,0,0,3,7,1370,0,98014,47.6499,-121.915,1160,7500,6130,6340,60,-210,0,123,415000.0,0.0052573410901499,0.0006253035848904,0.0056166416582622,0.0,0.0048988969035593,0.0007773880011924,0.7397590361445783
3179100060,880000.0,4,3.5,2800,6750,2.0,0,0,3,9,1890,910,98105,47.669,-122.275,2370,6120,3950,3750,69,-430,-630,229,675000.0,0.0056854869822653,0.0057557171325102,0.0048736210746721,0.0086931601069927,0.0051016564238895,0.0054109731352257,1.3037037037037038
5104511040,380000.0,4,2.5,2000,6921,2.0,0,0,3,8,2000,0,98038,47.3559,-122.014,2430,6339,4921,3909,17,430,-582,586,342750.0,0.0015865939160469,0.0004646111444377,0.0016586333524629,0.0,0.0019559563700991,0.0005405489296124,1.1086797957695114
6837700005,738000.0,3,1.75,1520,5500,1.5,0,0,5,7,1520,0,98116,47.5839,-122.383,2310,5500,3980,3190,84,790,0,329,565500.0,0.0024906110517588,0.0033573249811226,0.003253689298359,0.0,0.0041432822328524,0.0033929610247482,1.3050397877984086
6385260160,665000.0,4,2.5,2480,15411,2.0,0,2,3,8,2480,0,98059,47.5379,-122.16,2940,14679,12931,11739,26,460,-732,465,435000.0,0.002212685468545,0.0022987751351617,0.0023437352335229,0.0,0.0026874275011586,0.0025061732378805,1.528735632183908
1562100030,515000.0,4,1.75,1730,7980,1.0,0,0,4,8,1730,0,98007,47.6219,-122.138,2080,8400,6250,6320,55,350,420,139,560000.0,0.0056812584151587,0.0053657483706078,0.0065849573690621,0.0,0.0070199122510968,0.0062983529806955,0.9196428571428572
6300500183,305000.0,4,2.0,1780,5043,1.0,0,0,3,7,870,910,98133,47.7045,-122.342,1350,5044,3263,3694,27,-430,1,484,375000.0,0.0022797189541981,0.001468231693541,0.0013162791964342,0.0075932044991822,0.0017990860642793,0.0015500050243025,0.8133333333333334
3363400655,549000.0,2,2.0,1980,6000,1.5,0,0,5,7,1220,760,98103,47.6809,-122.351,1280,3900,4020,2620,114,-700,-2100,599,550000.0,0.002002002002002,0.0028788452375982,0.0014495732670173,0.0051566327188346,0.0014023708832745,0.0018755626688006,0.9981818181818182
3420069060,790000.0,3,2.5,2640,432036,1.5,0,3,3,10,2640,0,98022,47.1795,-122.036,1500,560617,429396,559117,24,-1140,128581,233,280000.0,0.0061668698930608,0.0249782297021675,0.0065576376607118,0.0,0.0035734705546026,0.0467305370214495,2.821428571428572
3438503140,269000.0,1,1.0,1020,7920,1.0,0,0,3,7,1020,0,98106,47.5385,-122.355,1000,7168,6900,6168,73,-20,-752,330,315000.0,0.0020727031096642,0.004336416094455,0.0025939611567032,0.0,0.0022229039127554,0.0042602610598588,0.8539682539682539
1449000260,493000.0,3,2.25,1790,11393,1.0,0,0,3,8,1790,0,98052,47.6297,-122.099,2290,11894,9603,9604,42,500,501,571,615000.0,0.0013243386814913,0.0017947526366779,0.0014896705081856,0.0,0.0017174282973685,0.0020726822432088,0.8016260162601626
8151600101,115000.0,2,1.0,790,7252,1.0,0,0,3,5,790,0,98146,47.5048,-122.365,1260,11470,6462,10210,90,470,4218,281,312000.0,0.0017281433615232,0.0028641265776491,0.00203977299134,0.0,0.0029143864291364,0.0049383077491391,0.3685897435897436
4364700585,485000.0,3,1.75,2180,7318,1.0,0,0,4,7,1210,970,98126,47.5251,-122.37,2140,7560,5138,5420,53,-40,242,352,396587.5,0.004008509808897,0.0040761808001746,0.0027527339653246,0.0093018795550441,0.0043048475802331,0.0042810182707744,1.2229331484224792
2023049206,289950.0,3,2.5,1760,8584,1.5,0,0,5,7,1760,0,98148,47.4612,-122.325,2160,8584,6824,6424,83,400,0,56,279000.0,0.0193683283812039,0.0170648939109898,0.0210023866348448,0.0,0.0239414763910441,0.0173863024130988,1.039247311827957
7504010590,790000.0,4,3.0,3180,12070,2.0,0,0,4,9,3180,0,98074,47.6371,-122.058,3110,12600,8890,9490,44,-70,530,435,645000.0,0.002756757740811,0.0019018563346863,0.0029884718289541,0.0,0.0027605159235612,0.0021920828231521,1.2248062015503876
3732800525,300000.0,4,1.75,1820,5015,1.0,0,0,4,6,1190,630,98108,47.5569,-122.31,1530,9130,3195,7600,94,-290,4115,185,345000.0,0.0057680727664564,0.0051957551250451,0.0049517310252996,0.008376545672118,0.0052633389521483,0.0097577867244937,0.8695652173913043
5589300145,415000.0,3,2.25,1950,8868,1.0,0,0,3,7,1350,600,98155,47.7538,-122.312,1300,8880,6918,7580,56,-650,12,442,377225.0,0.0024757503427962,0.0019471926106807,0.0020726820505734,0.0044017313476634,0.0017109247811661,0.0020442341891261,1.100139174232885
1402000070,390000.0,4,2.25,1770,33132,1.0,0,0,4,8,1190,580,98058,47.4413,-122.151,2490,20000,31362,17510,55,720,-13132,451,335000.0,0.0019099372849971,0.003753155807961,0.0014585442502714,0.005232295895354,0.0027890440971393,0.0032143411042708,1.164179104477612
2755200110,820000.0,3,1.75,2160,6272,1.0,0,0,4,8,1390,770,98115,47.6777,-122.306,1290,5376,4112,4086,60,-870,-896,576,570000.0,0.0020452473092215,0.0019977417109804,0.0017135425334541,0.0031438580446019,0.0013239310283249,0.0017658414139081,1.4385964912280702
1130000005,1600000.0,3,2.25,3170,5000,2.0,0,0,5,10,2230,940,98102,47.6349,-122.318,3170,5400,1830,2230,45,0,400,104,710000.0,0.0141701943149359,0.0133356092773166,0.0122356710963819,0.0226751899650223,0.0155954050131601,0.0157175955571596,2.2535211267605635
1023059223,311000.0,3,1.0,1640,12060,1.0,0,0,4,7,1640,0,98059,47.4941,-122.151,1680,9147,10420,7467,60,40,-2913,465,435000.0,0.0014632274872636,0.0017989246726397,0.00154988942862,0.0,0.0015356728578049,0.0015616844885137,0.7149425287356321
1925069099,915000.0,3,2.5,3140,9808,2.0,0,0,3,9,2500,640,98052,47.6383,-122.097,2370,10014,6668,7644,19,-770,206,571,615000.0,0.0023231415976999,0.0015450657298813,0.0020805454024939,0.0042663822411839,0.0017774257924731,0.001745068100176,1.4878048780487805
1454100650,942000.0,4,2.75,3160,37200,2.0,0,3,3,8,2310,850,98125,47.7214,-122.285,3130,20000,34040,16870,81,-30,-17200,402,425000.0,0.0044870556962888,0.0120283130969899,0.0040362528895901,0.0064425664152802,0.0046915423333003,0.0067947984458936,2.216470588235294
2998300146,936000.0,3,1.75,2960,12420,1.0,0,2,4,8,1480,1480,98116,47.5739,-122.406,2700,9106,9460,6406,68,-260,-3314,329,565500.0,0.0048501373113198,0.0075814502300988,0.0031680658957706,0.0103402501222664,0.0048427974150223,0.0056175096529741,1.6551724137931034
9834200305,615000.0,3,1.0,1790,3876,1.5,0,0,5,7,1090,700,98144,47.575,-122.288,1360,4080,2086,2720,116,-430,204,340,452500.0,0.002753913942497,0.0027833690111069,0.0021661324202455,0.0047689446325528,0.0022712583940533,0.0030580856383903,1.3591160220994476
4299000130,341950.0,5,3.0,3070,5252,2.0,0,0,3,8,3070,0,98042,47.3666,-122.128,2760,5203,2182,2443,15,-310,-49,546,292000.0,0.0028352995720267,0.000506280500219,0.0030434972261546,0.0,0.0025828500627464,0.0006469091840464,1.1710616438356165
8682262240,505000.0,2,2.5,1900,5065,2.0,0,0,3,8,1900,0,98053,47.7175,-122.034,1350,4664,3165,3314,15,-550,-401,400,635000.0,0.0018128629303879,0.0003593300527055,0.0018678248491485,0.0,0.0013641668729758,0.0004014352515236,0.7952755905511811
1326069191,334000.0,3,2.25,1840,9781,2.0,0,0,3,7,1840,0,98019,47.7347,-121.976,1490,10101,7941,8611,31,-350,320,190,401250.0,0.0044595681974619,0.0012921946607166,0.0047559229333705,0.0,0.0037277305626371,0.0014362012285556,0.832398753894081
6064800550,247800.0,3,2.5,1580,2170,2.0,0,0,3,7,1580,0,98118,47.5418,-122.289,1610,1917,590,307,17,30,-253,498,370000.0,0.0018702496546548,0.0007529383680043,0.0023785687940806,0.0,0.0020046143483073,0.0006925497971121,0.6697297297297298
2818600010,1185000.0,7,3.5,3890,8342,2.0,0,4,3,9,2840,1050,98117,47.7011,-122.392,2870,8342,4452,5472,52,-1020,0,548,545000.0,0.0041922711332495,0.0032835500127334,0.0038827093655324,0.005344871468567,0.0034005545155098,0.0032793909814782,2.1743119266055047
9202650130,620000.0,4,2.5,1910,7683,2.0,0,0,3,8,1910,0,98027,47.5644,-122.092,1980,8485,5773,6505,33,70,802,411,571000.0,0.0018470542386026,0.0005676868898317,0.0021977541484047,0.0,0.0020268216059183,0.000724447556443,1.085814360770578
7153200160,1378600.0,5,3.25,3450,6360,2.0,0,0,5,9,1860,1590,98122,47.6133,-122.287,2310,5000,2910,2690,115,-1140,-1360,289,574000.0,0.0066735788178673,0.0062802347385852,0.0043038220716655,0.0187522113456775,0.004669515542816,0.0048629853867289,2.401742160278745
2523069134,495000.0,4,2.5,2480,91911,1.0,0,2,4,7,1470,1010,98027,47.4579,-121.981,2540,91911,89431,89371,47,60,0,411,571000.0,0.0023982693778715,0.0067911843981938,0.0016914652346361,0.0061208411611417,0.0026000640803194,0.0078473422934874,0.8669001751313485
6145601312,322000.0,3,3.25,1380,1225,3.0,0,0,3,7,1380,0,98133,47.7035,-122.351,1380,1704,-155,324,20,0,479,484,375000.0,0.0017674225599963,0.000356649578542,0.0020878911391715,0.0,0.0018390657545966,0.0005236337354107,0.8586666666666667
4137000250,355000.0,4,2.5,2130,9268,2.0,0,0,4,8,2130,0,98092,47.262,-122.22,2100,8400,7138,6300,35,-30,-868,351,309780.0,0.0027638037725272,0.0008125820100234,0.0029388755282732,0.0,0.0028088459923117,0.0007921485255852,1.1459745625928075
686400040,545000.0,4,2.25,1890,7210,1.0,0,0,3,8,1890,0,98008,47.6342,-122.117,1920,7210,5320,5290,53,30,0,283,545000.0,0.0031303570097637,0.0025005800582728,0.0038984826857864,0.0,0.0033567607258995,0.0026832060330082,1.0
2695600195,379500.0,2,1.0,960,5096,1.0,0,0,5,7,960,0,98126,47.5314,-122.378,1760,4488,4136,2728,71,800,-608,352,396587.5,0.0017652153286886,0.0028385101609306,0.0021839872782741,0.0,0.0035404353930889,0.0025414298940787,0.956913669745012
3395071610,299950.0,3,2.5,1320,3150,2.0,0,0,3,7,1320,0,98118,47.5328,-122.282,1390,1725,1830,335,15,70,-1425,498,370000.0,0.0015624870532559,0.0010929750503288,0.0019871587393585,0.0,0.0017306918907746,0.000623186437151,0.8106756756756757
9347300160,312000.0,3,2.5,1780,4077,2.0,0,0,3,8,1780,0,98038,47.3568,-122.056,1970,4077,2297,2107,9,190,0,586,342750.0,0.0014120685852818,0.0002736916104425,0.0014761836836919,0.0,0.001585693024319,0.0003476601965657,0.9102844638949672
2525310040,206000.0,3,1.0,1060,10350,1.0,0,0,4,7,1060,0,98038,47.365,-122.028,1500,9660,9290,8160,40,440,-690,586,342750.0,0.0008408947755048,0.0006948021015648,0.0008790756768053,0.0,0.0012073804753698,0.000823742334762,0.6010211524434719
5104531120,775000.0,5,2.75,3750,12077,2.0,0,4,3,10,3750,0,98038,47.3525,-122.002,3120,7255,8327,4135,15,-630,-4822,586,342750.0,0.002974863592588,0.0008107367131013,0.0031099375358679,0.0,0.0025113513887692,0.0006186594864077,2.261123267687819
4054530260,1820000.0,4,4.5,6640,53330,2.0,0,0,3,12,6640,0,98077,47.7283,-122.046,4620,68625,46690,64005,27,-2020,15295,196,652475.0,0.0118646642067739,0.0049410621069178,0.0126663169440602,0.0,0.0084761310681392,0.0076733120251002,2.7893789034062606
2872900390,507000.0,3,2.25,1810,8158,1.0,0,0,3,8,1450,360,98074,47.6258,-122.038,1740,9532,6348,7792,36,-70,1374,435,645000.0,0.0015690979593924,0.0012854468913315,0.0013626679723218,0.0040250447227191,0.001544468716076,0.0016583280531973,0.786046511627907
4055700378,1415000.0,4,3.25,3600,38016,2.0,0,2,3,11,3310,290,98034,47.7124,-122.253,2440,22693,34416,20253,29,-1160,-15323,543,446000.0,0.0033523673300629,0.007165590238542,0.0036676713057353,0.0016920671225523,0.0023487623273924,0.0049218592755564,3.172645739910314
7846700850,307000.0,3,1.0,1150,6000,1.5,0,0,3,7,1150,0,98045,47.4963,-121.787,1210,7700,4850,6490,93,60,1700,218,404750.0,0.0025481094136024,0.0005440296822594,0.0027124880591558,0.0,0.0028962958530309,0.0010885163084482,0.7584928968499074
8700500020,324950.0,3,2.5,1560,9600,1.0,0,0,3,7,1210,350,98188,47.457,-122.27,2070,9600,8040,7530,56,510,0,135,265000.0,0.0063979788948721,0.0070152515954216,0.0060024902893597,0.0082852002651264,0.0093566088395092,0.0072855266183545,1.2262264150943396
3324079092,361000.0,2,2.5,1320,48787,1.0,0,0,3,8,1320,0,98027,47.5157,-121.924,1830,155073,47467,153243,16,510,106286,411,571000.0,0.0012764982172541,0.0036048080559964,0.0015188667413059,0.0,0.0018732745145608,0.0132401008745196,0.6322241681260946
687600110,778000.0,3,2.25,2260,33080,1.0,0,0,5,9,1690,570,98005,47.6386,-122.183,3020,35291,30820,32271,46,760,2211,168,765475.0,0.0050633705468664,0.0098804194459079,0.0046567634667261,0.0068320747932398,0.0070004473795841,0.0114366323523407,1.0163623893660798
1025039320,1305000.0,4,3.5,3440,5000,2.0,0,0,3,11,2560,880,98199,47.6672,-122.409,3090,10241,1560,7151,14,-350,5241,316,689900.0,0.0050346129641283,0.0029087490517478,0.005090374023185,0.0048791306276336,0.0049080339273801,0.0061354802221977,1.8915784896361791
8643200035,299900.0,3,1.75,1470,27000,1.0,0,0,3,7,1470,0,98198,47.3943,-122.311,2230,14186,25530,11956,62,760,-12814,275,266750.0,0.0030553644509385,0.0093033128063201,0.0036172060897017,0.0,0.0047257777401034,0.0054288301265247,1.12427366447985
6648500390,219000.0,3,2.25,1940,6500,1.0,0,0,3,8,1440,500,98042,47.3565,-122.149,1880,8991,4560,7111,41,-60,2491,546,292000.0,0.0017916876774371,0.0006265847774987,0.0014275687314862,0.0067503712704198,0.0017593326514359,0.0011178859261506,0.75
1236300214,700000.0,3,2.5,2190,7982,2.0,0,0,3,8,2190,0,98033,47.6869,-122.187,2090,8888,5792,6798,16,-100,906,431,678000.0,0.0021355248954421,0.0017624055621537,0.002468821267486,0.0,0.0021969427806778,0.0020768213604161,1.0324483775811208
381000110,599950.0,4,1.75,2720,7810,1.0,0,0,3,8,1510,1210,98115,47.6788,-122.283,2120,7315,5090,5195,68,-600,-495,576,570000.0,0.0025754966116122,0.0024876216139599,0.0018614742629609,0.004940348355803,0.0021757626201929,0.0024027399447057,1.0525438596491228
8035350120,515000.0,3,2.5,3020,12184,2.0,0,0,3,8,3020,0,98019,47.744,-121.976,2980,10029,9164,7049,17,-40,-2155,190,401250.0,0.0073195086719212,0.0016096615628434,0.0078059169884668,0.0,0.0074554611252742,0.0014259639759612,1.2834890965732086
2061800045,435000.0,6,2.5,2270,11970,1.0,0,0,3,7,1470,800,98011,47.7722,-122.204,2270,10640,9700,8370,56,0,-1330,194,470000.0,0.0051861531994224,0.0054434303888937,0.0038671082711395,0.0138949196699956,0.0052000412338071,0.005762855256466,0.925531914893617
8948500065,210000.0,2,1.0,970,8874,1.0,0,0,3,7,970,0,98056,47.4943,-122.178,1340,8175,7904,6835,52,370,-699,404,380000.0,0.0011907085452364,0.0022932721380614,0.0013430513017905,0.0,0.0017372928051444,0.0025835334584174,0.5526315789473685
9477200560,440000.0,3,1.75,1530,7245,1.0,0,0,4,7,1530,0,98034,47.731,-122.191,1530,7490,5715,5960,36,0,245,543,446000.0,0.0014247561152767,0.0013656013593812,0.0016953284283308,0.0,0.0014727894921764,0.0016244976853619,0.9865470852017936
2026049183,324950.0,2,1.5,1230,1516,3.0,0,0,3,8,1230,0,98125,47.7265,-122.314,1352,1411,286,59,20,122,-105,402,425000.0,0.0017465438311503,0.0004901860928773,0.002149173616535,0.0,0.0020265064647354,0.0004793730303578,0.7645882352941177
2122049096,182500.0,2,1.0,1040,13920,1.0,0,0,3,6,1040,0,98198,47.3756,-122.306,1100,7575,12880,6475,47,60,-6345,275,266750.0,0.0021616183870585,0.0047963746023695,0.0025591117913536,0.0,0.0023311011274052,0.0028988712962374,0.6841611996251171
6392002635,594000.0,4,1.75,1870,5200,2.0,0,0,4,7,1200,670,98115,47.6843,-122.283,1790,5000,3330,3210,83,-80,-200,576,570000.0,0.0017706539204834,0.0016562909593587,0.0014793172950683,0.0027355647920562,0.0018370825896911,0.0016423376245425,1.0421052631578946
8718500610,379950.0,3,1.5,1690,9144,1.0,0,0,4,7,1140,550,98028,47.739,-122.253,1840,10600,7454,8760,64,150,1456,282,442500.0,0.0028215055486826,0.0027245512639635,0.0022686973498032,0.005700663349917,0.0031202941216372,0.0037177315804813,0.8586440677966102
2391600335,804000.0,4,2.5,2620,5060,2.0,0,0,3,9,2620,0,98116,47.5634,-122.394,900,5060,2440,4160,15,-1720,0,329,565500.0,0.004293026944479,0.0030887389826328,0.0056083328695399,0.0,0.0016142658050074,0.0031215241427683,1.4217506631299734
321100260,896000.0,5,2.75,2520,16100,1.0,0,3,4,8,1570,950,98040,47.528,-122.224,2760,16988,13580,14228,60,240,888,282,993750.0,0.0028762953316128,0.0041659561684484,0.0022500541016193,0.005326127176704,0.0033763698152538,0.0047058667099542,0.901635220125786
1796351080,208000.0,3,2.0,1250,7995,1.0,0,0,4,7,1250,0,98042,47.3684,-122.092,1540,7650,6745,6110,40,290,-345,546,292000.0,0.0011544379364929,0.0007706992763235,0.001239208968304,0.0,0.0014411554697932,0.0009511541914194,0.7123287671232876
